ADL-funksjon	N	ADL-toiminto	
ADL-gjøremål	N	ADL-toiminnot	
ADL-indeks	N	ADL-indeksi	
AV-knute	N	AV-solmuke eteis-kammiosolkuke	
CO-narkose	N	häkänarkoosi	#heahki#narkosa
CO2-narkose	N	hiilidioksidinarkoosi	#hilla#dioksiida#narkosa
EKG-monitor	N	EKG-monitori	
EKG-undersøkelse	N	EKG-tutkimus	
EPJ-system	N	elektroninen potilaskertomus  sähköinen potilaskertomus	elektrovnnalaš #buohccimuitalus 
EU-direktiv	N	EU-direktiivi	#EU-direktiiva
ICNP-begrep	N	ICNP-käsite	
ICNP-diagnose	N	ICNP-diagnoosi	
IVF-behandling	N	koeputkihedelmöitys in vitro fertilisaatio	IVF	*koeputkihedelmöitys 
KMI-verdi	N	painoindeksi  BMI	#deaddu#indeksa  
LIS-lege	N	erikoistuva lääkäri	*erikoistuva doavttir
MNA-skjema	N	MNA-testilomake	
MONA-behandling	N	akuutissa sydänkohtauksessa käytettävä hoito: morfiini, happi, nitroglyseriini, asetyylisalisyylihappo	*akuutissa váibmodohppehagas #atnámuš dikšu#: *morfiini, oksygena, #nitro#glyseriidna, 
MS-medisin	N	MS-tautilääke	
NIC-klassifikasjon	N	NIC-luokitus	
PICO-skjema	N	PICO-taulukko	
REM-søvn	N	REM-uni	
absorpsjon	N	imeytyminen	njammásit
abstraksjonsnivå	N	abstraktiotaso	abstrakšuvdnadássi
acetylsalisylsyre	N	asetyylisalisyylihappo	
adaptasjon	N	adaptaatio	
adaptasjonsevne	N	sopeutumiskyky	sajáiduvvat gálga
adaptasjonsnivå	N	sopeutumistaso	sajáiduvvat dássi
adaptasjonsområde	N	sopeutumisalue	sajáiduvvat guovlu
adrenalin	N	adrenaliini	
aids	N	aids	
aktivitetsmønster	N	aktiviteettitapa	
aktivitetsmulighet	N	aktiviteettimahdollisuus	
aktivitetsplan	N	aktiviteettisuunnitelma	
aktivitetstiltak	N	aktiviteettitoimenpide aktiviteettikeino	
aktivitetstoleranse	N	liikunnan sietokyky	lášmmohallama 
aktivitetsutfoldelse	N	aktiviteetin suorittaminen	buđaldeami čađahit
akupunktur	N	akupunktio	
alarmknapp	N	hälytysnappi	alárbmaboallu
alarmmatte	N	hälyttävä matto	#alarmeret rátnu
alarmsymptom	N	ennakko-oire  esioire	*ennakko-symptoma  
albumin	N	albumiini	álbumasan
aldersdemens	N	vanhuudendementia	#boarisvuohta#dementia
aldersendring	N	ikääntymismuutos	agáiduvvat iežáhus
aldersforandring	N	vanhenemismuutos	boarásmit iežáhus
alderssykdom	N	vanhuuden sairaus	boarisvuođa buohcu
aldringsprosess	N	vanhenemisprosessi	boarásmit proseassa
alkoholskade	N	alkoholin aiheuttama vamma	alkohola *aiheuttama veaidni
allergiforbund	N	allergialiitto	allergiijalihttu
allergikost	N	allergiaruoka	allergiijagušta
allergireaksjon	N	allergiareaktio yliherkkyysreaktio	allergiijareakšuvdna 
allmennlege	N	yleislääkäri	
allmennmedisin	N	yleislääketiede	
allmennsykepleie	N	yleissairaanhoito kuntatasolla	*yleissairaanhoito gieldadásis
allmennsykepleier	N	yleissairaanhoitaja	
allmenntilstand	N	terveydentila	healssadilli
altruisme	N	altruismi	
alvorlighetsgrad	N	vakavuusaste	#duođalašvuohta#ráđđa
ambivalens	N	ambivalenssi 	kaksijakoisuus	
amfetamin	N	amfetamiini	
amming	N	imetys	
amøbe	N	ameba	
anamnese	N	anamneesi	esitiedot	
anamneseskjema	N	esitietolomake	
åndedrag	N	hengenveto	heakkahiistu
anestesisykepleier	N	anestesiasairaanhoitaja	#anestesia#buohccidikšu
angstlidelse	N	ahdistuneisuushäiriö	
angstsymptom	N	ahdistusoire	áŧestussymptoma
ankelknoke	N	kehräsluu	behkeš
ansiktskrem	N	kasvovoide	njeazzevuoiddas
ansiktsuttrykk	N	kasvojen ilme	#muođut geahčastat
anstrengelsesinkontinens	N	ponnistusinkontinenssi	rahčamušinkontineansa
antibiotika	N	antibiootti	#antibiotika
antibiotikabehandling	N	antibioottihoito	
antibiotikabruk	N	antibioottien käyttö	#antibiotika atnin
antikonsepsjonsmiddel	N	ehkäisyaine	prevenšuvdnaávnnas
antistoff	N	vasta-aine	cagganávnnas
apopleksi	N	aivoverenkiertohäiriö	
arbeidsantrekk	N	työasu	bargogárvu
arbeidshverdag	N	työn arki	barggu árga
arbeidskapasitet	N	työkapasiteetti	#bargu#kapasitehtta
arbeidskår	N	työolosuhteet	bargoeksisteansagorit
arbeidslys	N	työvalo	bargočuovga
arbeidsrutine	N	työrutiini	bargorutiidna
åreforkalkning	N	valtimonkovettumatauti	ateroskleroosi	
årevegg	N	suonen seinämä	suona seaidni
armbrudd	N	käsivarren murtuma	giehtanađa 
arrdanning	N	arpeutuminen	
årsaksforklaring	N	selonteko syy-yhteydestä	*selonteko ártaoktavuođas
årsakstenkning	N	syy-yhteysajattelu	#árta#oktavuohtajurddašeapmi
arterie	N	valtimo	váibmosuotna	váibmosuotna
arterieblod	N	valtimoveri	váibmosuotnavarra
arteriesykdom	N	valtimosairaus	váibmosuotnabuohcu
arterietermometer	N	valtimolämpömittari	
aspirasjon	N	aspiraatio	keuhkoihin vetäminen	aspirašuvdna
aspirere	N	aspiroida	vetää henkeen pois	
astmaanfall	N	astmakohtaus	#ástmá#dohppehallat
atferdsendring	N	käytöksen muutos	ealagearddi iežáhus
atferdsfaktor	N	käytöstekijä	#ealageardi#dahkki
atferdsforstyrrelse	N	käytöshäiriö	ealageardesegohus
atferdsterapi	N	käytösterapia	ealageardeterapiija
atrium	N	kammio	gámmir
atrofi	N	atrofia		#atrofia
autisme	N	autismi	
autonomiprinsipp	N	autonomian periaate	autonomiija prinsihppa
aversjon	N	inho	
avfallsbøtte	N	jäteastia	bázahuslihtti
avfallsstoff	N	kuonanaineet	
avføringsinkontinens	N	ulosteinkontinenssi	ulosteen pidätyskyvyttömyys	luhčainkontineansa
avføringsinkontinens	N	ulosteinkontinenssi ulosteen pidätyskyvyttömyys ulosteen karkailu	luhčainkontineansa luža *pidätyskyvyttömyys luža 
avføringskart	N	ulosteluokitus	luhčaluohkkájuohku
avføringsklump	N	ulostemöykky	
avføringslekkasje	N	ulosteen karkaamineN	 ulosteinkontinenssi	luža lovpet
avføringsproblem	N	ulostusongelma	
avføringsprøve	N	ulostenäyte	luhčačájánas
avføringsrefleks	N	ulostusrefleksi	
avføringsrest	N	ulostejäämä	
avføringstrang	N	ulostamisen tarve	*ulostamisen dárbu
avlastningsmadrass	N	painetta helpottava patja	deattu #álkidit guoddá
avlastningsopphold	N	lyhytaikaishoito	
avslapningsteknikk	N	rentoutustekniikka rentoutumistekniikka	
avvenne	N	vieroittaa	
avvikshåndtering	N	vahinkoilmoituksen tekeminen	vahátalmmuhusa dahkat
avvikshendelse	N	vaaratilanne	várredilli
avviksskjema	N	vahinkoilmoituslomake	vahátalmmuhusskovvi
bachelor	N	alempi korkeakoulututkinto	vuolit allaskuvladutkan
bachelorstudent	N	alemman korkeakoulutason opiskelija bacheloropiskelija	vuolibu allaskuvladási studeanta 
bakgrunnsforståelse	N	taustaymmärrys	duogášádden
bakhode	N	takaraivo	duohkemoarri
baktericid	N	bakterisidi	bakteereja tappava aine	
bakterieflora	N	bakteerifloora mikrobiomi	
bakterieflora	N	bakteerikanta	
bakterieinnhold	N	bakteerimäärä	
bakterieinvasjon	N	bakteeri-invaasio	
bakterieoppvekst	N	bakteerikasvu	
bakteriepanel	N	bakteeripaneeli	
bakteriestamme	N	bakteerikanta	
bakterietall	N	bakteeriluku  bakteerimäärä	
bakterietoksin	N	bakteerimyrkky	
bakterietype	N	bakteerityyppi	
bakterievandring	N	bakteerien kulku	baktearaid johtu
bakterievekst	N	bakteerikasvu	
balanseøvelse	N	tasapainoharjoitus	balánsahárjehus
balansesystem	N	tasapainojärjestelmä	balánsavuogádat
balansetenkning	N	tasapainoajattelu	balánsajurddašeapmi
balje	N	astia	allas	lihtti
bandasjeskift	N	siteen vaihto	čatnasa #molsuheapmi
barmhjertighet	N	armo	árbmu
barselavdeling	N	synnyttäneiden osasto	#guoddit ossodat
barselkvinne	N	synnyttänyt nainen 1-6 viikkoa synnytyksestä	#guoddit nisson #1-#6 vahkku 
baseline	N	lähtökohta vertailukohta	vuolggačuokkis veardádusčuokkis
basis	N	alusta	álggus
bedøvelse	N	puudutus	
begrepsfeste	N	käsitteellistää	
behandler	N	???	?
behandlingsalternativ	N	hoitovaihtoehto	dikšomolssaeaktu
behandlingsansvar	N	hoitovastuu	dikšovástu
behandlingsforløp	N	hoitoketju	dikšoviđji
behandlingskvalitet	N	hoidon laatu	divššu dássu
behandlingsmiljø	N	hoitoympäristö	dikšobiras
behandlingsmulighet	N	hoitomahdollisuus	dikšoliiba
behandlingsopplegg	N	hoidon suunnitelma	divššu plána
behandlingspakke	N	hoitopakkaus	
behandlingsplan	N	hoidon suunnitelma	divššu plána
behandlingsregime	N	hoidon suunnitelma	divššu plána
behandlingsrutine	N	hoitokäytäntö	dikšogeavat
behandlingssituasjon	N	hoitotilanne	dikšodilli
behandlingssvikt	N	hoidon epäonnistuminen	divššu eahpelihkostuvvat
behandlingssystem	N	hoitojärjestelmä	dikšovuogádat
behandlingstiltak	N	hoitotoimenpide	dikšodoaibmabidju
behandlingsvalg	N	hoitovalinta	dikšoválljen
behovsdekning	N	tarpeen tyydytys	dárbbu 
behovsmodell	N	tarvemalli tarvekaavio	dárbomálle dárbodiagrámma
behovsområde	N	tarvealue	dárboguovlu
behovsteori	N	tarveteoria	dárboteoriija
behovstilfredsstillelse	N	tarpeiden tyydytys	dárbbuid 
beinbrudd	N	luunmurtuma	
beinklær	N	housut	buvssat
beinmarg	N	luuydin	dákteađa
beinstrekk	N	jalan ojennus	juolggi 
beintetthet	N	luuntiheys 	#dákti#deahtisvuohta 
bekvemmelighetsgrunn	N	mukavuussyy	
belegg	N	peite	govččas
ben	N	luu	dákti
beskyttelsesutstyr	N	suojavaruste	suodjerusttet
beslutningsforum	N	päätöksentekofoorumi	#čovdojupmi#dahkuforum
beslutningsstøtte	N	päätöstuki	čovdojupmeduvdda
besøkshistorikk	N	vierailuhistoria	galledanhistorjá
besøkstjeneste	N	ystävätoiminta	ustitdoaibma
besvimelse	N	pyörtyminen	jámálgit
betennelsesprosess	N	tulehdusprosessi	vuolšeproseassa
betennelsesreaksjon	N	tulehdusreaktio	vuolšereakšuvdna
betennelsessykdom	N	tulehdussairaus	vuolšebuohcu
betennelsestilstand	N	tulehdustila	ei bakteerin aiheuttama, esim. rasitusvamma	vuolšedilli
betydningsinnhold	N	merkityssisältö	oaivilsisdoallu
bevegelighetstrening	N	liikeharjoittelu	gávpehárjehallan
bevegelsesforstyrrelse	N	liikkumishäiriö	lihkkat segohus
bevegelsesinnskrenkning	N	liikerajoite	gávperáddjen
bevegelseskapasitet	N	liikkumiskapasiteetti	lihkkat #kapasitehtta
bevisstgjøring	N	tietoiseksi tekeminen	#diđolaš dahkat
bevissthetsinnhold	N	tajunnan sisältö	diđolašvuođa sisdoallu
bevissthetsnivå	N	tajunnan taso	diđolašvuođa dássi
bevissthetstap	N	tajunnan menetys	diđolašvuođa massin
bevissthetstilstand	N	tajunnantila	diđolašvuođadilli
binyremarg	N	lisämunuaisydin	#lassi#monimušađa
biokjemi	N	biokemia	
biomedisin	N	biolääketiede	
blåmerke	N	mustelma	
blæredysfunksjon	N	rakon toimintahäiriö	ráhku doaibmasegohus
blærefunksjon	N	rakon toiminta	ráhku doaibma
blærefylling	N	virtsarakon täyttyminen	gužžaráhku dievvat
blærehals	N	virtsarakon kaula	gužžaráhku čeabi
blærekapasitet	N	virtsarakon kapasiteetti	gužžaráhku #kapasitehtta
blærekatarr	N	virtsarakontulehdus	gužžaráhkovuolši
blærekateter	N	rakkokatetri	#ráhkku#katehtár
blærekontroll	N	virtsarakon hallinta	gužžaráhku kontrolla
blæremuskel	N	rakkolihas	ráhkkooažži
blæremuskulatur	N	rakkolihakset	ráhkkooaččit
blæreregion	N	virtsarakon alue	gužžaráhku guovlu
blæreskade	N	virtsarakon vaurio  virtsarakon vamma	gužžaráhku #vaháguvvan gužžaráhku  veaidni
blæreskylling	N	rakkohuuhtelu  virtsarakon huuhtelu	#ráhkku#doidildeapmi gužžaráhku  #doidildeapmi
blærespreng	N	paineen tunne virtsarakossa	deattu dovdu gužžaráhkus
blæretømming	N	rakon tyhjentäminen	rakon tyhjentyminen	ráhku gurret
blæretrening	N	virtsarakon harjoitus	gužžaráhku hárjehus
blæretrykk	N	virtsarakon paine	gužžaráhku deaddu
blærevegg	N	rakon seinämä	ráhku seaidni
blærevolum	N	virtsarakon tilavuus	gužžaráhku #daddjásvuohta
bleiesensor	N	vaipan kosteusindikaattori 	lihpara lávttasindikáhtor 
blindtarmbetennelse	N	umpilisäkkeen tulehdus	*umpilisäkkeen vuolši
blindtarmsbetennelse	N	umpilisäketulehdus	
blodbane	N	verisuonisto	
blodcelle	N	verisolu	varrasealla
blodforsyning	N	veren saanti	vara oažžun
blodfylling	N	verellä täyttyminen	varas dievvat
blodgass	N	verikaasu	varragássa
blodglukose	N	veren glukoosi	vara glukosa
blodkultur	N	veriviljely	varragilvin
blodlager	N	verivarasto	varrarádju
blodlegeme	N	verisolu	varrasealla
blodmengde	N	verimäärä	varramearri
blødningssjokk	N	vuotosokki	suođđošohkka
blødningstendens	N	vuototaipumus	suođđotendeansa
blodomløp	N	verenkierto	varagarvin
blodplasma	N	veriplasma	varravarragolggus
blodprøveglass	N	verinäytteenottoputki	#varračájánas#váldinbohcci
blodprøvesvar	N	verikoevastaus	varraiskkusdávástus
blodsirkulasjon	N	verenkierto	varagarvin
blodstrøm	N	verenvirtaus	vararávdnji
blodsukkermåling	N	verensokerin mittaus	varasohkkara mihtideapmi
blodsukkernivå	N	verensokeritaso	
blodsukkerstigning	N	verensokerin nousu	varasohkkara #loktaneapmi
blodsukkerverdi	N	verensokeriarvo	
blodtilførsel	N	verensaanti	varaoažžun
blodtilstrømning	N	verenvirtaus	vararávdnji
blodtransfusjon	N	verensiirto	varasirdin
blodtrykksapparat	N	verenpainemittari	
blodtrykksfall	N	verenpaineen lasku	varradeaddaga rehket
blodtrykksmåling	N	Verenpaineen mittaus	Varradeaddaga mihtideapmi
blodtrykksmåling	N	verenpaineen mittaus	varradeaddaga mihtideapmi
blodtrykksmansjett	N	verenpainemansetti	
blodverdi	N	veriarvo	varraárvu
blodviskositet	N	veren viskositeetti	vara 
blodvolum	N	verivolyymi	varravoluma
blotte	N	paljastaa	
bluferdighet	N	häveliäisyys	heahpu
bluferdighetsregel	N	siveyssääntö	
bofellesskap	N	asumisyhteisö	orrot orgána
brannskade	N	palovamma	dollaveaidni
brekningssenter	N	oksennuskeskus	#vuovssanas#guovddaš
bronkie	N	keuhkoputki	geahpesbohcci
bronkiegrein	N	keuhkoputken haara	geahpesbohcci #hárči
bruddskade	N	murtumavamma	
brukermedvirkning	N	potilaan osallistuminen hoitoon	#buohcci searvat dikšui
brukerombud	N	potilasasiamies	#buohcci#ásiialmmái
brukerrettighet	N	kotihoitopotilaan oikeudet	#ruoktu#dikšu#buohcci rievttit
brukerrettighet	N	potilaan oikeudet	#buohcci rievttit
brukerrettighetslov	N	laki potilaan oikeuksista	láhka #buohcci rivttiin
brukerstyring	N	asiakaslähtöisyys	
brystbein	N	rintalasta	mielga
brysthinne	N	rintakalvo	raddecuozza
brysthule	N	rintaontelo	
brystkompresjon	N	rintalastan paineluelvytys	mielgga 
brystmuskel	N	rintalihas	raddeoažži
brystprotese	N	rintaproteesi	raddedahkulahttu
brystvegg	N	rinnan seinämä	ratti seaidni
bufferteori	N	puskuriteoria	
buffervirkning	N	puskurivaikutus	
bukhinne	N	vatsakalvo	čoavjecuozza
bukmuskulatur	N	vatsalihakset	čoavjeoaččit
bukorgan	N	vatsaelin	čoavjeorgána
buktrykk	N	vatsanpaine	čoavjjedeaddu
bukvegg	N	vatsan seinämä	čoavjji seaidni
bunnpunkt	N	alin piste	*alin čuokkis
bust	N	takku	duoggi
cellebiologi	N	solubiologia	seallabiologiija
cellegift	N	solumyrkky	seallamirko
cellemembran	N	solukalvo	seallacuozza
cellemetabolisme	N	soluaineenvaihdunta solumetabolia	#sealla#ávnnasmolsašuvvan #sealla#metabolia
cellestoff	N	kuivauspaperi	
colon	N	paksusuoli	gassačoalli
dagsplan	N	paiväsuunnitelma	
dagvakt	N	päivävuoro	beaivevuorru
dannelse	N	tapakasvatus	dáhpebagadus
datainnsamling	N	tietojenkeruu	
datasamling	N	tietojen keruu	dieđuid 
dehydrere	N	kuivua	goikat
delirium	N	sekavuustila	seahki
delprotese	N	osaproteesi	oassedahkulahttu
deltasøvn	N	syvä uni  deltauni	#čieŋal nagir  
demensomsorg	N	dementiahoito	#dementiadikšu
demenssykdom	N	dementiasairaus	#dementiabuohcu
desibel	N	desibeli	
desinfeksjonsmiddel	N	desinfektioaine	desinfekšuvdnaávnnas
detaljoppfatning	N	yksityiskohtien ymmärtäminen	#detálja ipmárdus
determinant	N	determinantti	determinánta
diabetesdagbok	N	diabetespäiväkirja	diabetesbeaivegirji
diagnosemanual	N	tautiluokituksen käsikirja  tautiluokituksen ohjekirja	dávdaluohkkájuogu giehtagirji dávdaluohkkájuogu  bagadusgirji
diagnosesystem	N	diagnoosijärjestelmä	diagnosavuogádat
diagnostikk	N	diagnostiikka	
diagnostisering	N	diagnosointi	
diakonisse	N	diakonissa	
dialysebehandling	N	dialyysihoito	#dialysadikšu
diaréplage	N	ripulivaiva	
diettregime	N	ruokavaliosuunnitelma	#diehttaplána
diffusjon	N	diffuusio	diffušuvdna
dikotomi	N		
disiplinfag	N	akateeminen oppiaine	tieteenhaara	#akademalaš fága
disputas	N	väitöstilaisuus	
dl	N	dl	desilitra	
døgnrytmeforstyrrelse	N	vuorokausirytmin häiriö	jándorritmma segohus
døgnrytmekurve	N	vuorokausirytmin käyrä	jándorritmma sodju
døgnurin	N	vuorokausivirtsa	jándorgužža
døgnvariasjon	N	vuorokausivaihtelu	jándormolsun
døgnvolum	N	vuorokausivolyymi	jándorvoluma
doktorgradsprogram	N	tohtoriohjelma	
doktorgradsutdanning	N	tohtorikoulutus	
dokumentasjonsplikt	N	kirjaamisvelvollisuus  kirjaamisvelvoite	*kirjaamisvelvollisuus  
dokumentasjonssystem	N	kirjaamisjärjestelmä  dokumentaatiojärjestelmä	*kirjaamisjärjestelmä  dokumentašuvdnavuogádat
dørterskel	N	kynnys	šielbmá
dosering	N	annostelu	
dostol	N	WC-tuoli	
dråpesamler	N	virtsankarkailusuoja  tippasuoja	gužžagolgansuodji goaikkanassuodji  
dråpeteller	N	tipanlaskija	
drikkeliste	N	nestelista	#siedja#lista
drikkemengde	N	juoman määrä	juhkat #mearri
drikkerestriksjon	N	nesterajoitus	siedjaoahci
drikkeskjema	N	nestelista	#siedja#lista
drikkevane	N	juomistapa	juhkat
drikkevare	N	juotava	jugahahtti
drypp	N	TIA-kohtaus	aivojen iskeeminen kohtaus	
dusjstol	N	suihkutuoli	riššostovla
e-helse	N	e-terveyspalvelut	
e-helse	N	sähköinen terveydenhuolto	elektrihkalaš healssadikšun
e-helsetiltak	N	sähköinen terveydenhoidon palvelu	#elektrihkalaš dearvvasvuođafuolahusa bálvalus
e-konsultasjon	N	eKonsultaatio	etävastaanotto	
egenaktivitet	N	omaehtoinen aktiivisuus	*omaehtoinen aktiviteahtta
egenmestring	N	suoriutuminen itse	*suoriutuminen ieža
egennytte	N	oma hyöty	#ieš gudda
egenomsorgsbehov	N	itsehoitotarve	#iešdikšudárbu
egenomsorgsevne	N	itsehoitokyky	#iešdikšugálga
egenomsorgshandling	N	itsehoidollinen toiminta	*itsehoidollinen doaibma
egenomsorgskrav	N	itsehoitovaatimus	#iešdikšugáibádus
egenomsorgsmodell	N	itsehoitomalli	#iešdikšumálle
egenomsorgsrådgivning	N	itsehoidon neuvonta	#iešdikšu rávvehus
egenomsorgssvikt	N	itsehoidon vaje	#iešdikšu 
egenomsorgstenkning	N	itsehoitoajattelu	#iešdikšujurddašeapmi
egenomsorgsteori	N	itsehoitoteoria	#iešdikšuteoriija
egenvekt	N	ominaispaino	
eggløsning	N	munasolun irtoaminen	monneseala luovvanit
eksempellæring	N	esimerkin avulla oppiminen	eksempela veahkis oahppat
ekskrement	N	uloste	luhča
ekspansjonsmulighet	N	laajenemismahdollisuus	
ekspertsammenslutning	N	asiantuntijasyhmä	
eksponering	N	altistuminen	
ekstensjon	N	ojennus	
ekstrakt	N	uute	
eliminasjon	N	eritys	vuohčun
emboli	N	embolia	veritulppa	
emisjon	N	emissio	säteily	
empatievne	N	empatiakyky	empatiijagálga
endringsarbeid	N	muutostyö	iežáhusbargu
energibalanse	N	ravitsemustasapaino	biebmobalánsa
energiforbruk	N	energiankulutus	alvvagolahus
energiinnhold	N	energiasisältö	alvasisdoallu
energiinntak	N	energiansaanti	alvvaoažžun
energimengde	N	energiamäärä	alvamearri
energiomsetning	N	energia-aineenvaihdunta	#alva#ávnnasmolsašuvvan
energiprosent	N	energiaprosentti	alvaproseanta
energirik	N	energiapitoinen	
energitetthet	N	energiatiheys	#alva#deahtisvuohta
epikrise	N	epikriisi	hoitotiivistelmä	
epitelcelle	N	epiteelisolu	
eplesyre	N	omenahappo	ebelsuvri
ereksjonsevne	N	erektiokyky	erekšuvdnagálga
ereksjonsproblem	N	erektio-ongelma	erekšuvdnaproblema
ereksjonspumpe	N	erektiopumppu	erekšuvdnapumpa
erfaringsgrunnlag	N	kokemusperusta	vásihusvuođus
erfaringskunnskap	N	kokemustieto	vásihusdiehtu
erfaringslæring	N	kokemusoppiminen	
ergoterapeut	N	toimintaterapeutti	doaibmaterapevta
ernære	N	ravita	
ernæringsarbeid	N	ravitsemustyö	biebmobargu
ernæringsbehov	N	energiantarve	alvvadárbu
ernæringsforhold	N	ravitsemustila	biebmodilli
ernæringsfysiolog	N	ravitsemusterapeutti	biebmoterapevta
ernæringsinntak	N	ravinnonsaanti	biebmamaoažžun
ernæringskartlegging	N	ravitsemuksen arviointi ravitsemuksen kartoitus	biepmu evalueren biepmu kárten
ernæringsløsning	N	ravintoliuos	biebmančuokkisčoahkku
ernæringsonde	N	ravitsemusletku	biebmolággá
ernæringsplan	N	ravitsemussuunnitelma	biebmoplána
ernæringsproblem	N	ravitsemusongelma	biebmoproblema
ernæringspumpe	N	ravintopumppu	biebmanpumpa
ernæringsstatus	N	ravitsemustila	biebmodilli
ernæringstilskudd	N	ravintolisä	biebmanlassi
ernæringstilstand	N	ravitsemustila	biebmodilli
ernæringstrapp	N	ravitsemuksen portaat	biepmu ráhpat
ernæringsvæske	N	ravintoliuos	biebmančuokkisčoahkku
erstatningskrav	N	korvausvaatimus	buhtadasgáibádus
evalueringskriterium	N	arviointikriteeri	evaluerenkriteara
evalueringsskjema	N	arviointilomake	evaluerenskovvi
evidens	N	evidenssi	näyttö	
fagartikkel	N	ammattialan artikkeli	
fagprosedyre	N	ammattialan menetelmä  ammattialan toimenpide	
fagutøver	N	ammattialan harjoittaja	
fagutvikling	N	ammattialan kehitys	
fallrisiko	N	kaatumisriski	ravgat riska
fargeforandring	N	värimuutos	ivdneiežáhus
farmasi	N	farmasia	
faselidelse	N	jaksottainen vaiva	*jaksottainen váivi
fastlege	N	omalääkäri	
feberkurve	N	kuumekäyrä	febersodju
feberperiode	N	kuumejakso	feberoassi
feberstigning	N	kuumeen nousu	febera #loktaneapmi
febertilstand	N	kuumetila	feberdilli
feilstilling	N	virheasento	feailastellelmas
feiltrinn	N	harha-askel	govahallanlávki
fellesmåltid	N	yhteinen ateria	#oktasaš mális
fenomen	N	ilmiö	albmoneapmi	fenomena	fenomena
ferdighetskunnskap	N	käytännön tietotaito	geavada diehtodáidu
ferdighetslæring	N	käytännön taitojen oppiminen	geavada dáidduid oahppat
ferdighetstrening	N	kädentaitojen harjoittelu	gieđadáidduid hárjehallan
ferdighetsutøvelse	N	käytännön taitojen harjoittelu	geavada dáidduid hárjehallan
festemiddel	N	kiinnitysaine	giddehusávnnas
fettinnhold	N	rasvan määrä	buoiddi #mearri
fettlager	N	rasvavarasto	buoiderádju
fettmasse	N	rasvamassa	#buoidi#mássá
fettomsetning	N	rasva-aineenvaihdunta	#buoidi#ávnnasmolsašuvvan
fettstoffskifte	N	rasva-aineenvaihdunta	#buoidi#ávnnasmolsašuvvan
fiberinnhold	N	kuitumäärä	fiibermearri
fiberinntak	N	kuidun saanti	fiibera oažžun
fibermengde	N	kuidun määrä	fiibera #mearri
fibertilskudd	N	kuitulisä		fiiberlassi
fibertype	N	kuitutyyppi	fiibertiipa
fibromyalgi	N	fibromyalgia	
fingerferdighet	N	sorminäppäryys	
fingergrep	N	sormiote	suorbmatáhka
fingerledd	N	sorminivel	suorbmalađas
fingertrykk	N	sormen painallus	suorpma 
fissur	N	fissuura  halkeama  haavauma	*fissuura  *halkeama  uddu
fistel	N	fisteli	
flaskekost	N	pulloharja	bohtalkusta
fleksjon	N	koukistus	
fluor	N	fluori	
fødemiddel	N	ravintoaine 	biebmanávnnas 
fødselsskade	N	syntymävamma	riegádanveaidni
fødselsvekt	N	syntymäpaino	riegádandeaddu
foldtykkelse	N	esim. niskapoimun paksuus	*esim. *niskapoimun assodat
følelsesmodus	N	tunnetila	dovdodilli
følelsesuttrykk	N	tunteenilmaisu	#dovdudajahus
folkehelsepolitikk	N	kansanterveyspolitiikka	álbmogahealsapolitihkka
folkehelseproblem	N	kansanterveysongelma	álbmogahealsaproblema
forbedringsarbeid	N	parannustyö	buorádusbargu
forbedringstiltak	N	parannustoimenpide	buorádusdoaibmabidju
forbrenningsvæske	N	polttoneste	boaldensiedja
forbrukerundersøkelse	N	asiakastutkimus potilastyytyväisyystutkimus	kunddardutkan #buohcci#duhtavašvuohtadutkan
fordampning	N	haihdunta	
fordampningsvarme	N	haihtumislämpö	
fordøyelsesbesvær	N	ruoansulatusvaiva	suolbmudanváivi
fordøyelsesenzym	N	ruoansulatusentsyymi	
fordøyelsesorgan	N	ruoansulatuselin	suolbmudanorgána
fordøyelsesprosess	N	ruoansulatusprosessi	suolbmudanproseassa
fordøyelsessystem	N	ruoansulatusärjestelmä	
forfallstendens	N	rappioitumistaipumus	
forflytning	N	siirto	siirtäminen	sirdin
forflytningshjelpemiddel	N	siirtoapuväline	#sirdin#veahkki#gaskoapmi
forflytningsteknikk	N	siirtotekniikka	sirdinteknihkka
forforståelse	N	esiymmärrys	
forklaringsmodell	N	selitysmalli	čilgehusmálle
førlighet	N	liikuntakyky	lášmmohallangálga
forløp	N	kulku	johtu
formålsrasjonalitet	N	tavoiterationaalisuus	
formynderi	N	huoltajuus	
forordning	N	määräys	dákti
forråtnelsesprosess	N	mätänemisprosessi	
forskningsartikkel	N	tutkimusartikkeli	dutkanartihkal
forskningslitteratur	N	tutkimuskirjallisuus	dutkangirjjálašvuohta
forskningsmetode	N	tutkimusmenetelmä	dutkanmannolat
forskningsområde	N	tutkimusala	dutkansuorgi
forståelsesform	N	käsitystapa	ipmárdusdáhpi
forståelsesmåte	N	ymmärrystapa	áddendáhpi
forståelsesramme	N	ymmärrysperusta	áddenvuođus
forsvarlighet	N	riittävä hoito	#bistit dikšu
fortrolighetskunnskap	N	kokemusperäinen tieto	*kokemusperäinen diehtu
fremmedgjøring	N	vieraantuminen	
fremmedlegeme	N	vierasesine	guossediŋga
frivillighetssentral	N	vapaaehtoiskeskus	
fronesiskunnskap	N	käytäntöön pohjautuva tieto	geavadii *pohjautuva diehtu
frostskade	N	paleltuma	suvččageapmi
fruktjuice	N	hedelmätuoremehu	heđenmáihli
fuktighetskrem	N	kosteusvoide	lávttasvuoiddas
funksjonsbegrensning	N	toimintarajoite	doaibmaráddjen
funksjonsdyktighet	N	toimintakyky	doaibmagálga
funksjonsforstyrrelse	N	toimintahäiriö	doaibmasegohus
funksjonsnedsettelse	N	alentunut toimintakyky	*alentunut doaibmagálga
funksjonssvikt	N	alentunut toimintakyky	*alentunut doaibmagálga
funksjonstap	N	toimintakyvyn vaje	doaibmagálgga 
funksjonsundersøkelse	N	toimintakyvyn tutkimus	doaibmagálgga dutkan
funksjonsvurdering	N	toiminnan arviointi	doaimma evalueren
fyllende	N	täydentävä	#dievasmahttit
gallefargestoff	N	sappiväriaine	sáhppeivdneávnnas
gallegang	N	sappitiehyt	
gallestein	N	sappikivi	sáhppegeađgi
gallesykdom	N	sappikivitauti	sáhppegeađgedávda
gangfunksjon	N	kävelykyky	vázzingálga
ganghastighet	N	kävelynopeus	vázzinjohtilvuohta
ganghjelpemiddel	N	apuväline kävelyyn	#veahkki#gaskoapmi vázzimii
gasbind	N	sideharso	
gåsehud	N	iho kananlihalla	liiki vuoncábierggus
gassdannelse	N	kaasunmuodostus	
gassutveksling	N	kaasujen vaihto	gásaid #molsuheapmi
gassutvikling	N	kaasunmuodostus	
gåstol	N	rollaattori	
genetikk	N	genetiikka	perinnöllisyystiede	
genital	N	sukupulielimet	
genitale	N	sukupuolielimet	sohkabealleorgánat
giftbehandling	N	myrkkykäsittely	mirkogieđahallan
giftstoff	N	myrkkyaine	mirkoávnnas
gingivitt	N	ientulehdus	gingiviitti	aldnavuolši
gipse	N	kipsata	
gisping	N	haukottelu	
glukoseintoleranse	N	glukoosi-intoleranssi	
glutenintoleranse	N	gluteeni-intoleranssi	#glutenaintoleránsa
glykogen	N	glykogeeni	glykogena
glykogenlager	N	glykogeenivarasto	glykogenarádju
glyserol	N	glyseroli	
graviditetshormon	N	raskaushormoni	#lossatvuohtahormona
grensesetting	N	rajojen asettaminen	rájiid ásahit
grunnlidelse	N	perussairaus	vuođđobuohcu
grunnvilkår	N	perusehto	vuođđoeaktu
gruppeaktivitet	N	ryhmätoiminta	joavkodoaibma
gruppenivå	N	ryhmätaso	joavkodássi
gruppesamling	N	ryhmäkokous	joavkočoakkán
gruppetilhørighet	N	ryhmään kuuluminen	jovkui gullot
guiding	N	ohjaus	bagadallan
habilitering	N	kuntoutus	veajuiduhttin
habiliteringstjeneste	N	toimintarajoitteisen lapsen kuntoutus	*toimintarajoitteisen máná veajuiduhttin
hallusinogen	N	hallusinogeeni	
hælsene	N	akillesjänne	
halsmuskel	N	päänkiertäjälihas	
hånddesinfeksjon	N	käsidesinfektio	giehtadesinfekšuvdna
håndhygiene	N	käsihygienia	giehtabuhtisindoallan
handikap	N	vamma	veaidni
håndlag	N	kädentaito	ote	gieđadáidu
håndledd	N	käden nivel	gieđa lađas
handlingsalternativ	N	toimintavaihtoehto	doaibmamolssaeaktu
handlingsberedskap	N	toimintavalmius	doaibmaválmmašvuohta
handlingsforløp	N	toimintaketju	doaibmaviđji
handlingsklokskap	N	toimintaviisaus	doaibmaviisodat
handlingskunnskap	N	käytännön tieto	geavada diehtu
handlingsmønster	N	toimintatapa	doaibmadáhpi
handlingsrefleksjon	N	toiminnan reflektointi	doaimma 
handlingsregel	N	toimintasääntö	doaibmanjuolggadus
handlingsrepertoar	N	toimintarepertuaari	
handlingsvalg	N	toimintatavan valinta	doaibmadábi válljen
håndtrykk	N	kädenpuristus	
håravfall	N	hiustenlähtö  hiuskato	vuovttaidvuolgga vuoktavátnun  
hårvaskhette	N	hiustenpesumyssy	vuovttaidbassangahpir
hårvekst	N	hiusten kasvu  karvojen kasvu	vuovttaid šaddu  guolggaid šaddu
hastverksinkontinens	N	pakkoinkontinenssi	bággoinkontineansa
healing	N	paraneminen	
helhetsforståelse	N	kokonaiskäsitys	
helhetsoppfatning	N	kokonaiskäsitys	
helhetsvurdering	N	kokonaisarviointi	
helsebegrep	N	terveyskäsite	healsadoaba
helsedefinisjon	N	terveyden määritelmä 	healssa definišuvdna 
helsefagarbeider	N	lähihoitaja	#lagasdivššár
helseforetak	N	terveydenhoitoalan toimija terveydenhoitoalan yritys	dearvvasvuođafuolahussuorggi aktevra dearvvasvuođafuolahussuorggi viggamuš
helseforhold	N	terveysolosuhteet	healsaeksisteansagorit
helsefremmende	A	terveyttä edistävä	healssa #ovddidit
helsegevinst	N	terveyshyöty	healsagudda
helsehistorie	N	esitiedot anamneesi  terveydenhuollon historia 	*esitiedot *anamneesi  healssadikšuma historjá 
helsehjelp	N	terveydenhoito	dearvvasvuođafuolahus
helseinformatikk	N	terveystietojenkäsittelytiede	
helsekompetanse	N	terveysosaaminen	healsamáhttu
helsemodell	N	terveysmalli	healsamálle
helseomsorg	N	terveydestä huolehtiminen	healssas fuolahit
helseopplysning	N	terveysneuvonta	healsarávvehus
helseopplysning	N	terveystieto	healsadiehtu
helsepedagogikk	N	terveyspedagogiikka	healsapedagogihkka
helsepersonelltjeneste	N	terveydenhoitohenkilökunnan palvelut	dearvvasvuođafuolahusolmmošgieldda bálvalusat
helseplage	N	terveysongelma	healsaproblema
helseproblem	N	terveysongelma	healsaproblema
helseressurs	N	terveysresurssi terveyttä koskeva voimavara	healsaresursa healssa #girjet fápmoráđđi
helseresultat	N	terveystulos	healsaboađus
helserisiko	N	terveysriski	healsariska
helsesjekk	N	terveystarkastus	healsadárkkistus
helsesykepleier	N	terveydenhoitaja	healssadikšu
helseteam	N	terveysalan monitieteellinen ryhmä 	healsasuorggi *monitieteellinen joavku 
helsetjenestetilbud	N	terveyspalvelujen tarjonta	dearvvasvuođabálvalusaid fállu
helseutfall	N	terveysvaikutus	healsaváikkuhus
helseutgift	N	terveydenhoitomeno	dearvvasvuođafuolahusmannu
helsevane	N	terveystapa	healsadáhpi
helseveiledning	N	terveysohjaus	healsabagadallan
helsevirksomhet	N	terveydenhoidon toimija	dearvvasvuođafuolahusa aktevra
hemning	N	esto	caggaseapmi
hemoglobininnhold	N	hemoglobiinin määrä	hemoglobiinna #mearri
hemoglobinkonsentrasjon	N	hemoglobiinikonsentraatio	
hemoglobinmolekyl	N	hemoglobiinimolekyyli	hemoglobiidnamolekyla
hemoglobinnivå	N	hemoglobiinitaso	hemoglobiidnadássi
hemoglobinverdi	N	hemoglobiiniarvo	hemoglobiidnaárvu
hepatitt	N	hepatiitti	maksatulehdus	
heteslag	N	lämpöhalvaus	#liekkas#ravkin
hetetokt	N	kuuma aalto	#báhkas bárru
hg	N	hg	hektogramma	
hjelpemetode	N	auttamistoimenpide	veahkehit doaibmabidju
hjemmeoppfølging	N	kotiseuranta	#ruoktučuovvuleapmi
hjemmesykepleietjeneste	N	kotisairaanhoidon palvelut	#ruoktubuohccedivššu bálvalusat
hjerneaktivitet	N	aivoaktiviteetti	vuoiŋŋašbuđaldeapmi
hjernebølge	N	aivoaalto	vuoiŋŋašbárru
hjernecelle	N	aivosolu	vuoiŋŋašsealla
hjernefunksjon	N	aivotoiminta	vuoiŋŋašdoaibma
hjernehalvdel	N	aivopuolisko	vuoiŋŋašbealli
hjernestamme	N	aivorunko	vuoiŋŋašriggi
hjernestamme	N	aivorunko		vuoiŋŋašriggi
hjernesvulst	N	aivokasvain	vuoiŋŋašguorti
hjertebank	N	sydämen tykytys	váimmu 
hjertebank	N	sydämentykytys	váibmogirddáhat
hjertebrett	N	sängyn selkäosa	seaŋgga sealgeoassi
hjertefrekvens	N	sydämen syke  sydämen lyöntitiheys	váimmu *syke  váimmu 
hjertefunksjon	N	sydämentoiminta	váimmodoaibma
hjertekammer	N	sydämen kammio	váimmu gámmir
hjertekammer	N	sydänkammio		váibmogámmir
hjertekontraksjon	N	sydänlihaksen supistuminen	váibmooačči 
hjertekrampe	N	sydänkouristus	
hjertelidelse	N	sydäntauti	váibmodávda
hjertemuskel	N	sydänlihas	váibmooažži
hjertemuskel	N	sydänlihas		váibmooažži
hjertemuskulatur	N	sydämen lihaksisto	váimmu 
hjerteproblem	N	sydänongelma	váibmoproblema
hjerterytme	N	sydämen rytmi	váimmu ritma
hjerteslag	N	sydämensyke	
hjertestans	N	sydänpysähdys	
hjertesykdom	N	sydansairaus	
hodeende	N	pääpuoli	oaivebealli
hodegjerde	N	sängyn pääpuoli  sängyn pääty	seaŋgga oaivebealli seaŋgga  noga
hodeskade	N	päävamma	oaiveveaidni
hoftebrudd	N	lonkkamurtuma	
holdbarhet	N	kesto	säilyvyys	bistu
hormonbehandling	N	hormonihoito	hormonadikšu
hormonnivå	N	hormonitaso	hormonadássi
hørselsproblem	N	kuulo-ongelma	gulluproblema
hørselsvanske	N	kuulo-ongelma	gulluproblema
hospital	N	sairaala	buohcceviessu
hospitalisere	N	kirjautua sairaalahoitoon	*kirjautua 
hospitering	N	vierailu oppimistarkoituksessa	galledeapmi oahppat ulbmilis
hosteanfall	N	yskänkohtaus	#gosahat#dohppehallat
hostekraft	N	yskimisvoima		gossat fápmu
hostemaskin	N	yskityslaite	
hosterefleks	N	yskänrefleksi	gosahatrefleaksa
hosteteknikk	N	yskimistekniikka	gossat teknihkka
hovedkomponent	N	pääkomponentti pääosatekijä	oaivekomponeanta #válduoassi#dahkki
hovedkriterium	N	pääkriteeri	oaivekriteara
hovedmåltid	N	pääateria	oaivemális
hovedpulsåre	N	aortta	
hudavdeling	N	ihotautien osasto	liikedávddaid ossodat
hudavdeling	N	ihotautiosasto	liikedávdaossodat
hudblødning	N	ihoverenvuoto	liikevarasuođđu
hudfett	N	ihon rasvakerros	liikki ráhpa
hudfold	N	ihopoimu	
hudforandring	N	ihomuutos	liikeiežáhus
hudfuktighet	N	ihonkosteus	liikkelávttas
hudkontakt	N	ihokontakti	liikekontákta
hudombud	N	iho-ongelmiin paneutunut vastuusairaanhoitaja	liikeproblemaide #čiekŋudit #vástu#buohccidikšu
hudområde	N	ihoalue	liikeguovlu
hudoverflate	N	ihon pinta	liikki aláš
hudpleie	N	ihonhoito	liikkedikšu
hudproblem	N	iho-ongelma	liikeproblema
hudsans	N	ihoaisti  tuntoaisti kosketusaisti	liikedovdda dovdodovdda  guoskkahusdovdda
hudskade	N	ihovaurio	#liiki#vaháguvvan
hudtemperatur	N	ihon lämpötila	liikki temperatuvra
hudtermometer	N	iholämpömittari	
hudtype	N	ihotyyppi	liiketiipa
hudvurdering	N	ihon arviointi	liikki evalueren
hukommelsesproblem	N	muistiongelma	muitoproblema
hullmerke	N	rei'ite	
humoralpatologi	N	humoraalioppi	
husstøvmidd	N	pölypunkki	dopmoširrá
hverdagskunnskap	N	arkitieto	árgadiehtu
hverdagsrehabilitering	N	arkikuntoutus	árgaveajuiduhttin
hvese	N	sihistä	kähistä	
hvilepuls	N	leposyke  lepopulssi	*leposyke  vuoiŋŋastanravkkas
hvilesmerte	N	lepokipu	vuoiŋŋastanbávččas
hvilestilling	N	lepoasento	vuoiŋŋastanstellelmas
hvilestoffskifte	N	lepoaineenvaihdunta	#vuoiŋŋasteapmi#ávnnasmolsašuvvan
hvilevolum	N	lepovolyymi	vuoiŋŋastanvoluma
hydrokarbonkjede	N	hiilivetyketju	hillačázaviđji
hygienerutine	N	hygieniatapa	buhtisindoallandáhpi
idealkropp	N	ihannekeho	
identifikasjon	N	identifikaatio	samastuminen	
identifisering	N	identifiointi	
idrettskonkurranse	N	urheilukilpailu	valáštallangilvu
indium	N	indium	
individnivå	N	yksilötaso	oktagasdássi
individualisere	N	yksilöllistää	
individualisme	N	yksilöllisyys	
infeksjonsforsvar	N	vastustuskyky infektiota kohtaan	vuosteháhkogálga infekšuvnna čuoggái
infeksjonsrate	N	infektioiden esiintyvyys	infekšuvnnaid 
infeksjonstilstand	N	tulehdustila  infektiotila	vuolšedilli infekšuvdnadilli  
inflammasjonsreaksjon	N	tulehdusreaktio	vuolšereakšuvdna
infusjon	N	infuusio	nesteensiirto	#infušuvdna
infusjonshastighet	N	infuusionopeus	#infušuvdnajohtilvuohta
infusjonspumpe	N	infuusiopumppu	#infušuvdnapumpa
infusjonssett	N	infuusiosetti	
infusjonsvæske	N	infuusioneste	#infušuvdnaeastta
inkontinens	N	inkontinenssi	virtsan karkailu	inkontineansa
inkontinensinnlegg	N	inkontinenssisuoja	inkontineansasuodji
inkontinensproblem	N	inkontinenssiongelma	inkontineansaproblema
inkontinensregister	N	inkontinenssirekisteri	inkontineansaregisttar
inkontinensutstyr	N	inkontinenssitarvikkeet	inkontineansabiergasat
innånding	N	sisäänhengitys	
innåndingsluft	N	sisäänhengitysilma	
inngangsport	N	sisäänmenoportti	
innleggelse	N	sisäänotto	
innvandrerbakgrunn	N	maahanmuuttajatausta	#sisafárrejeaddjiduogáš
inspirasjonsluft	N	sisäänhengitysilma	
inspirasjonsvolum	N	sisäänhengitysvolyymi	
institusjonsmiljø	N	laitosympäristö	ásahusbiras
institusjonsseng	N	hoitosänky	dikšoseaŋga
insulininjeksjon	N	insuliini-injektio insuliinin pistäminen	#insuliidna#injekšuvdna insuliinna cáhkit
integrering	N	integratio	liittäminen	
intensitet	N	intensiteetti	voimakkuus	
interaksjonsmodell	N	interaktiomalli	#interakšuvdnamálle
interaksjonsteori	N	interaktioteoria	#interakšuvdnateoriija
internundervisning	N	yksikön sisäinen koulutus	ovttadaga #siskkildas skuvlejupmi
intervensjonsstudie	N	interventiotutkimus	#intervenšuvdnadutkan
intimitet	N	intimiteetti	#intimitehtta
intimitetsgrense	N	intimiteettiraja	#intimitehttarádji
irritasjon	N	ärtyneisyys	
irritasjonshoste	N	ärsytysyskä	
isvann	N	jäävesi	jiekŋačáhci
iverksetting	N	toimeenpaneminen	
jernpreparat	N	rautavalmiste	
jerntilskudd	N	rautalisä	ruovdelassi
jodmangel	N	jodin puute	*jodin váilevuohta
jomfruhinne	N	immenkalvo hymen	
journalføring	N	potilastietojen kirjaus	#buohccidieđuid 
journalopplysning	N	potilaskertomukseen kirjattu tieto	#buohccimuitalussii *kirjattu diehtu
kalium	N	kalium	
kalori	N	kalori	kaloriija
kaloriinntak	N	kalorien saanti	kaloriijaid oažžun
karbohydratinntak	N	hiilihydraatien saanti	*hiilihydraatien oažžun
karbondioksid	N	hiilidioksidi	hilladioksiida
karbondioksidinnhold	N	hiilidioksidipitoisuus	hilladioksiidasisdoallu
karbondioksidnivå	N	hiilidioksiditaso	hilladioksiidadássi
karsystem	N	verisuonijärjestelmä	varrasuotnavuogádat
kartleggingssamtale	N	hoidon tarpeen arviointikeskustelu	divššu dárbbu evaluerengulahallan
kartleggingsundersøkelse	N	kartoitustutkimus	kártendutkan
kartleggingsverktøy	N	kartoitusväline	#kárten#gaskoapmi
karvegg	N	suonen seinämä	suona seaidni
kastrasjon	N	kastraatio kastroiminen	
kateterprøve	N	katetrinäyte	#katehtárčájánas
kateterspiss	N	katetrin kärki	#katehtár geahči
kateterstørrelse	N	katetrikoko	
katetersystem	N	katetrijärjestelmä	#katehtárvuogádat
katetertupp	N	katetrin pää	#katehtár #oaivi
katetertype	N	katetrityyppi	#katehtártiipa
kcal	N	kilokalori	gilokaloriija
keisersnitt	N	keisarileikkaus	
kilojoule	N	kilojoule	gilojoule
kilokalori	N	kilokalori	gilokaloriija
kinin	N	kiniini	
kjerneenhet	N	ydinyksikkö	ađaovttadat
kjernejournal	N	en digital løsning for deling av pasientenes helseopplysninger på tvers av virksomheter og nivåer i helsevesenet	in *digital *løsning *for *deling *av *pasientenes *helseopplysninger *på *tvers *av *virksomheter *og 
kjernejournal	N	sähköinen potilaskertomus	elektrihkalaš #buohccimuitalus
kjernetemperatur	N	ydinlämpötila	ađatemperatuvra
kjønnshormon	N	sukupuolihormoni	sohkabealhormona
kjønnslemlestelse	N		
kjønnsmajoritet	N	sukupuolienemmistö	sohkabealeanetlohku
kjønnsstudium	N	sukupuolentutkimus	sohkabealedutkan
kjønnstilhørighet	N	sukupuoleen kuuluminen	sohkabeallái gullot
kjønnsulikhet	N	sukupuoliero	sohkabealearru
kjønnsutvikling	N	sukupuolikehitys	sohkabealahtanuššan
kjøttbetennelse	N	pehmytkudostulehdus	
klamydiainfeksjon	N	klamydiainfektio	
klapptørke	N	kuivata taputtelemalla	goikkis 
klapptørking	N	taputtelukuivaus	
klassifikasjonssystem	N	luokittelujärjestelmä	klassifiserenvuogádat
klor	N	kloori	
klystersetting	N	peräruiskeen anto	*peräruiskeen addin
kognisjon	N	kognitio	tiedonkäsittelytoiminta	kognišuvdna
kolbe	N	lasiastia	mittalasi	láselihtti
koldbrann	N	kuolio	nekroosi	
kollegaveiledning	N	vertaisohjaus	
kolonisering	N	altistuminen	
koloskopi	N	paksusuolen tähystys	gassačoali 
kolssykdom	N	keuhkoahtaumatauti	geahpesbaskkádatdávda
kommunikasjonskapasitet	N	kommunikointikyky	
kommunikasjonsmiddel	N	kommunikaatioväline	
kommunikasjonsvanske	N	kommunikaatiovaikeus	
kompetansestige	N	urapolku  urakehitys	gurraluodda gurraahtanuššan  
komplikasjon	N	komplikaatio	
kompresjonsbandasje	N	kompressioside	komprešuvdnačanas
kompresjonsbehandling	N	kompressiohoito	komprešuvdnadikšu
kompresjonsbind	N	tukiside	duvddačanas
kompresjonsbrudd	N	kompressiomurtuma	
kompresjonsgrad	N	kompressioaste	#komprešuvdna#ráđđa
kompresjonsstrømpe	N	tukisukka 	duvddasuohkku 
kontaktallergi	N	kosketusallergia	guoskkahusallergiija
kontaktlinse	N	piilolinssi	
kontaktsykepleier	N	ohjaava sairaanhoitaja vastuusairaanhoitaja	#bagadallat #buohccidikšu #vástu#buohccidikšu
kontaktsykepleier	N	vastuusairaanhoitaja	#vástu#buohccidikšu
kontakttermometer	N	kontaktikuumemittari	
kontakttermometer	N	kosketuslämpömittari	
kontraksjon	N	supistus	
kontraktur	N	kontraktuura	kutistuma	
kontraktur	N	kontraktuura  kutistuma	*kontraktuura  
kontraktur	N	kutistuma	kontraktuura	
kontrollerbar	N	tarkistettavissa oleva	*tarkistettavissa #leat
kontrollspørsmål	N	kontrollikysymys	kontrollagažaldat
kontur	N	ääriviivat	hahmo	#ravda#linjá
kornvare	N	viljatuote	gordnebuvtta
koronapandemi	N	koronapandemia	koronapandemiija
korsrygg	N	ristiselkä	ristasealgi
kostfiber	N	ravintokuitu	biebmanfiiber
kostholdregime	N	ruokavaliosuunnitelma	#diehttaplána
kostholdsendring	N	ravitsemuksen muutos	biepmu iežáhus
kostholdsveiledning	N	ravitsemusneuvonta	biebmorávvehus
kostråd	N	ravitsemusneuvo	biebmoráđđi
kostregistrering	N	ravitsemuksen kartoitus	biepmu kárten
kostregistreringsskjema	N	ravinnon rekisteröintilomake	biebmama logahallanskovvi
kostsamtale	N	ravitsemuskeskustelu	biebmogulahallan
kostsirkel	N	ravintoympyrä	biebmangierdu
kosttilskudd	N	ravintolisä	biebmanlassi
kosttype	N	ravintotyyppi	biebmantiipa
kostveiledning	N	ravinto-ohjaus	biebmanbagadallan
kransarterie	N	sepelvaltimo	
kreftmedisin	N	syöpälääke	borasdálkkas
kreftpasient	N	syöpäpotilas	#boras#buohcci
kreftregister	N	syöpärekisteri		borasregisttar
kreftsvulst	N	syöpäkasvain	borasguorti
kreftsykdom	N	syöpätauti	borasdávda
kreftsykepleier	N	syöpätautien erikoissairaanhoitaja	borasdávddaid 
kremting	N	rykäisy rykiminen	*rykäisy himihit
krisereaksjon	N	kriisireaktio	heahtedillereakšuvdna
krisetilstand	N	kriisitila	heahtedilledilli
kroppsbevegelse	N	kehon liike	rupmaša gávpi
kroppsbilde	N	kehonkuva	rupmašagovva
kroppsendring	N	kehon muutos	rupmaša iežáhus
kroppsfasong	N	vartalomalli	máttamálle
kroppsforståelse	N	kehonymmärrys	rupmašaádden
kroppsideal	N	kehoihanne	
kroppskontakt	N	fyysinen kontakti	#fysalaš kontákta
kroppsleie	N	kehon asento	rupmaša stellelmas
kroppsmasse	N	kehon massa	rupmaša #mássá
kroppsoverflate	N	kehon ulkopinta	rupmaša 
kroppssammensetning	N	kehon rakenne	rupmaša ráhkadus
kroppsside	N	kylki	erttet
kroppsstell	N	kehon hoito	rupmaša dikšu
kroppsstilling	N	kehon asento	rupmaša stellelmas
kroppsstruktur	N	kehon rakenne	rupmaša ráhkadus
kroppstemperatur	N	kehon lämpötila	rupmaša temperatuvra
kroppsuttrykk	N	kehollinen ilmaisu	*kehollinen dajahus
kroppsvann	N	kehon vesi	rupmaša čáhci
kroppsvarme	N	kehonlämpö	rupmašaliekkas
kroppsvarme	N	ruumiinlämpö	rupmašaliekkas
kroppsvask	N	kehon pesu	rupmaša bassan
kroppsvæske	N	kehon nesteet	rupmaša siejat
kroppsvekt	N	kehonpaino	rupmašadeaddu
krybbedød	N	kätkytkuolema	gietkkajápmin
krykke	N	kyynärsauva	
kryssinfeksjon	N	risti-infektio	ristainfekšuvdna
kuldepåvirkning	N	kylmän vaikutus	galbmasa váikkuhus
kullos	N	häkä	hiilomonoksidi	heahki
kullsyre	N	hiilihappo	hillasuvri
kullsyrevann	N	hiilihappovesi	hillasuvrečáhci
kulturgrense	N	kulttuuriraja	
kulturkonflikt	N	kultuuriristiriita	
kunnskapsbegrep	N	tiedon käsite	dieđu doaba
kunnskapsform	N	tiedon laji	dieđu genre
kunnskapsinteresse	N	tiedonintressi	
kunnskapskomponent	N	tiedon elementti	dieđu elemeanta
kunnskapspyramide	N	tiedon pyramidi 	dieđu pyramiida 
kunnskapsvurdering	N	tiedon arviointi	dieđu evalueren
kunstutøvelse	N	taiteen harjoittaminen	dáidaga hárjehit
kurveføring	N	tietojen kirjaaminen	dieđuid 
kvalitetsdimensjon	N	laatu-ulottuvuus	dássoolli
kvalitetsforskrift	N	laatuasetus	dássoásahus
kvalitetskultur	N	laatukulttuuri	dássokultuvra
kvalitetsmål	N	laatutavoite	dássoulbmil
kvalitetsnivå	N	laadun taso	dásu dássi
kvalitetsnorm	N	laatunormi	dássonorbma
kvalitetsproblem	N	laatuongelma	dássoproblema
kvalitetssystem	N	laatujärjestelmä	dássovuogádat
kvalitetsutviklingsarbeid	N	laadunkehittämistyö	#dássu#ovddideapmibargu
kvalitetsutviklingsprosess	N	laadunkehitysprojekti	dásoahtanuššanprojeakta
kvalitetsutviklingsprosjekt	N	laadunparannushanke	dásobuorádusfidnu
kvalitetsutviklingstiltak	N	laadunkehittämistoimenpide	#dássu#ovddideapmidoaibmabidju
kveldsmåltid	N	iltapala	eahketborramuš
kvinnehelse	N	naisten terveys naisterveys	nissoniid healsa #nissonhealsa
kvinnekateter	N	naisten katetri	nissoniid #katehtár
kvinnesykdom	N	naistentaudit	nissoniiddávddat
laktoseintoleranse	N	laktoosi-intoleranssi	laktosaintoleránsa
laktosetoleranse	N	laktoosin sietokyky	laktosa 
lanolin	N	lanoliini	
lårbeinknute	N	iso sarvennoinen trochanter major	stuoris 
lårhalsbrudd	N	reisiluun kaulan murtuma	čoarbbealdávtti čeabáha 
læringsform	N	oppimismenetelmä	oahppat mannolat
låsbar	N	lukittava	
leddgikt	N	nivelreuma	lađasleasmi
leddkapsel	N	nivelkapseli	#lađas#kapsela
leddsans	N	niveltunto	lađasdovdu
leddsmerte	N	nivelkipu	lađasbávččas
leddvern	N	nivelen suojaus		lađđasa 
ledningssystem	N	impulssin johtojärjestelmä johtoratajärjestelmä	impulssa jođasvuogádat jođasluoddavuogádat
legemiddelbehandling	N	lääkehoito	dálkkasdikšu
legemiddelhåndbok	N	lääkeopas	dálkkasofelaš
legemiddelhåndtering	N	lääkehoidon toteuttaminen	dálkkasdivššu čađahit
legemiddelkurve	N	lääkityslista  lääkelista	#dálkun#lista #dálkkas#lista  
legemiddelliste	N	lääkityslista  lääkelista	#dálkun#lista #dálkkas#lista  
legemiddelregime	N	lääkehoitosuunnitelma	dálkkasdikšoplána
legemiddelsløyfe	N	ei ole Suomessa	ii leat Suomis
legemiddelvirkning	N	lääkeaineen vaikutus	dálkkasávdnasa váikkuhus
legetilsyn	N	lääkärinhoito	doaktáradikšu
legetime	N	lääkäriaika	doavtteráigi
legevisitt	N	lääkärinkierto	doaktáragarvin
leggmuskulatur	N	säärilihakset	
leiring	N	asentohoito	stellelmasdikšu
lekfolk	N	maallikko	
lengdesnitt	N	pitkittäisleikkaus	
lengdevekst	N	pituuskasvu	guhkkodatšaddu
leppepust	N	huulirakohengitys  huulihengitys	bavssasálvovuoigŋan bavssavuoigŋan  
leveår	N	elinvuosi	orgánajahki
levekårsproblem	N	elinehto-ongelma  elinolosuhdeongelma	orgánaeaktoproblema  
lidokain	N	lidokaiini	
liggetid	N	sairaalassaoloaika	
likevektsans	N	tasapainoaisti	balánsadovdda
likevektsorgan	N	tasapainoelin	balánsaorgána
likevektstilstand	N	tasapainotila	balánsadilli
lindring	N	lievitys	
litteraturgjennomgang	N	kirjallisuuskatsaus	#girjjálašvuohtadárkkistus
litteraturliste	N	lähdeluettelo	gáldolistu
litteratursøk	N	kirjallisuuskatsaus	#girjjálašvuohtadárkkistus
litteraturstudie	N	kirjallisuuskatsaus	#girjjálašvuohtadárkkistus
livkvalitetsbegrep	N	elämänlaadun käsite	#eallidásu doaba
livsbetingelse	N	elinolosuhteet	orgánaeksisteansagorit
livserfaring	N	elämänkokemus	#eallivásihus
livsfilosofi	N	elämänfilosofia	eallinfilosofiija
livsglede	N	elämänilo	#ealliillu
livshendelse	N	elämän tapahtuma	eallit dáhpáhus
livshistorie	N	elämäntarina	#eallimáinnas
livskraft	N	elinvoima	eallinvuoibmi
livskvalitetsproblem	N	elämänlaatuongelma	#ealli#dássuproblema
livslang	N	elämänpituinen	
livsmønster	N	elintapa	orgánadáhpi
livsmot	N	elämänhalu	#eallihállu
livsmulighet	N	elämän mahdollisuus	eallit liiba
livsperspektiv	N	perspektiivi elämään	perspektiiva #ealli
livsstilopplysning	N	elämäntapavalistus	eallinvuohkečuvgehus
livsstilsendring	N	elämäntapamuutos	eallinvuohkeiežáhus
livsstilsfaktor	N	elämäntapaan vaikuttava tekijä 	eallinvuohkái #čuohcit #dahkki 
livstestament	N	hoitotestamentti	dikšotestameanta
livsutfordring	N	elämän haaste	eallit hástalus
livsvane	N	elintapa	orgánadáhpi
livsverden	N	elämismaailma	eallit máilbmi
livsvilje	N	elämänhalu	#eallihállu
livsytring	N	elämän ilmentymä	eallit #albmanus
livsytring	N	elämänilmentymä	#ealli#albmanus
livvidde	N	vyötärön ympärysmitta	seakkáža 
loggføre	N	kirjata	
logoped	N	puheterapeutti	hupmaterapevta
lokaliseringsteknologi	N	paikallistamisteknologia	#lokaliserenteknologiija
lovforbud	N	lakisääteinen kielto	*lakisääteinen gieldu
luftdannelse	N	ilman muodostuminen	almmá 
luftforurensning	N	ilmansaaste	#ilbminuoskkideapmi
lufthunger	N	ilmannälkä	#ilbminealgi
luftmotstand	N	ilmanvastus	
luftpassasje	N	ilmatie	ilbmegeaidnu
luftplage	N	ilmavaiva	ilbmeváivi
luftsmerte	N	ilmavaiva	ilbmeváivi
luftstrømmotstand	N	ilmavirran vastus	ilbmeeanu 
luftstrømobstruksjon	N	ilmavirran tukkeuma ilmavirran obstruktio	ilbmeeanu *tukkeuma ilbmeeanu 
lufttemperatur	N	ilman lämpötila	almmá temperatuvra
luftveissykdom	N	hengityselinsairaus	vuoigŋanorgánabuohcu
luftvolum	N	 ilmatilavuus	 #ilbmi#daddjásvuohta
lukking	N	lukitseminen	lukitsemislaite	lásset
luktproblematikk	N	hajuongelmat	hádjaproblemat
luktsenter	N	hajukeskus	#hádja#guovddaš
lungeavsnitt	N	keuhkon osa	geahppá oassi
lungeemboli	N	keuhkoveritulppa  keuhkoembolia	*keuhkoveritulppa  
lungefunksjon	N	keuhkojen toiminta	geahppáid doaibma
lungehinne	N	viskeraalinen keuhkopussin lehti  keuhkon pintaan kiinnittyvä kalvo  pleura visceralis  lungekretsløp	N	keuhkoverenkierto	*viskeraalinen geahpesbusse lasta geahppá  alážii *kiinnittyvä cuozza  *pleura *visceralis  
lungeødem	N	keuhkopöhö keuhkoedeema	*keuhkopöhö geahpesødema
lungesekk	N	keuhkopussi	geahpesbusse
lungevolum	N	keuhkojen tilavuus	geahppáid #daddjásvuohta
lymfeknute	N	imusolmuke	
lymfesystem	N	imusuonisto	
madrasstrekk	N	patjansuojus	
mageleie	N	vatsa-asento	čoavjestellelmas
magemuskel	N	vatsalihas	čoavjeoažži
mageregion	N	vatsanseutu	čoavjjeguovlu
magesaft	N	mahaneste	čoavjjeeastta
magesekk	N	vatsalaukku	čoavjelávka
magesmerte	N	vatsakipu	čoavjebávččas
magnesium	N	magnesium	
maktbruk	N	vallankäyttö	#váldiatnin
malabsorpsjon	N	imeytymishäiriö	njammásit segohus
målinnhold	N	tavoitteiden sisältö	ulbmiliid sisdoallu
måltidsmiljø	N	ruokailuympäristö	borranbiras
måltidsmønster	N	ateriontikäytäntö	
mansjett	N	mansetti	
marihuana	N	marihuana	kannabis	
mask	N	maski	
maskebehandling	N	maskilla annettava happihoito	*maskilla *annettava oksygenadikšu
maskebruk	N	kasvomaskin käyttö kasvosuojaimen käyttö	*kasvomaskin atnin *kasvosuojaimen atnin
massasje	N	hieronta	#massáša
massasjestav	N	hierontasauva	#massášasoabbi
masseindeks	N	massaindeksi	#mássá#indeksa
master	N	master	
matallergi	N	ruoka-allergia	guštaallergiija
mathygiene	N	ruokahygienia	guštabuhtisindoallan
matinntak	N	ruoan saanti	guštta oažžun
matkort	N	ruokakortti	guštagoarta
matlukt	N	ruoan tuoksu	guštta 
matmangel	N	ruoan puute	guštta váilevuohta
matpyramide	N	ruokapyramidi	guštapyramiida
matregistrering	N	ruokamäärien kirjaaminen	guštameriid 
mattilbud	N	ruokatarjonta	guštafállu
matvane	N	ruokailutapa	borrandáhpi
matvaregruppe	N	ruokatavararyhmä	guštadávvirjoavku
matvareintoleranse	N	ruoka-aineintoleranssi	guštaávnnasintoleránsa
matvogn	N	ruokakärry	
medisindispenser	N	lääkeannostelija	
medisineringstidspunkt	N	lääkkeenantoaika	dálkasaaddináigi
medisinhistorie	N	lääketieteen historia	dálkkasdiehtaga historjá
melatoninutskilling	N	melatoniinin eritys	*melatoniinin vuohčun
melkegang	N	maitotiehyt	
melkesukker	N	maitosokeri	mielkesohkar
membranside	N	kalvopuoli	cuozzabealli
mengdekrav	N	määrällinen vaatimus	*määrällinen gáibádus
menneskekropp	N	ihmiskeho	
menneskeoppfatning	N	ihmiskäsitys	
menstruasjonsblod	N	kuukautisveri	#mensavarra
menstruasjonssyklus	N	kuukautiskierto	#mensagarvin
mentorordning	N	mentorointiohjelma	
menyplanlegging	N	ruokalistan suunnittelu	biebmolisttu plánenbargu
meskalin	N	meskaliini	
mesterlære	N	kognitiivinen oppipoikamalli	*kognitiivinen oahppogándamálle
mestring	N	selviytyminen	
mestringskompetanse	N	hallintataito	kontrolladáidu
mestringskurs	N	hallintakurssi	#kontrolla#gursa
metaanalyse	N	meta-analyysi	
metabolisme	N	aineenvaihdunta	metabolia	#ávnnasmolsašuvvan
metasyntese	N	metasynteesi	
migrene	N	migreeni	oaivebávččas
mikrobe	N	mikrobi	
mikroorganisme	N	mikro-organismi	
mikroskop	N	mikroskooppi	
mikroteori	N	mikroteoria	
mikstur	N	mikstuura	
militærformål	N	sotilaallinen tarkoitus	*sotilaallinen ulbmil
milliliter	N	millilitra	
mimikk	N	mimiikka 	ilmehtiminen	
minneaktivitet	N	muistelutoiminnot	#muitindoaimmat
minnealbum	N	muistoalbumi	muitoálbum
minnegruppe	N	muisteluryhmä	#muitinjoavku
minoritetshelse	N	vähemmistöterveys  vähemmistöjen terveys	veahádathealsa veahádagaid  healsa
minustegn	N	miinusmerkki	minusmearka
minuttventilasjon	N	minuuttikeuhkotuuletus minuuttiventilaatio	*minuuttikeuhkotuuletus 
minuttvolum	N	minuuttivolyymi	
mishandling	N	pahoinpitely	
ml	N	ml	millilitra	
mobilisering	N	liikkeellelähtö	
mol	N	mooli	
monitor	N	monitori	
morgenmedisin	N	ammulääke	
morgenrapport	N	ammuraportti	
morgenstell	N	aamupesu	iđitbassan
morgenurin	N	aamuvirtsa	iđitgužža
mortalitet	N	mortaliteetti	kuolleisuus	
motstandskraft	N	vastustuskyky	vuosteháhkogálga
motstandsressurs	N	vastustusresurssit	vuosteháhkoresurssat
muggsopp	N	homesieni	guohpaguoppar
multippel	N	multippeli	
munnhelse	N	suun terveys	njálmmi healsa
munnhygiene	N	suuhygienia	njálbmebuhtisindoallan
munnsårhet	N	suun arkuus	njálmmi 
munnslimhinne	N	suun limakavo	njálmmi 
munnspeil	N	suupeili	njálbmespeajal
munnstell	N	suunhoito	njálmmedikšu
munntørrhet	N	suun kuivuus	njálmmi 
musikkterapi	N	musiikkiterapia	musihkkaterapiija
muskelaktivitet	N	lihastoiminta	oažžedoaibma
muskelarbeid	N	lihastyö	oažžebargu
muskelatrofi	N	lihasten surkastuminen	oččiid 
muskelbruk	N	lihasten käyttö	oččiid atnin
muskelfiber	N	lihaskuitu	oažžefiiber
muskelgruppe	N	lihasryhmä	oažžejoavku
muskelknute	N	lihassolukasvaiN	 myooma	oažžeseallaguorti
muskelkontraksjon	N	lihassupistus	
muskelkraft	N	lihasvoima	oažžefápmu
muskelkrampe	N	lihaskramppi	suonenveto	oažžekrámpa
muskelkrampe	N	lihaskramppi	suonenveto		oažžekrámpa
muskelmasse	N	lihasmassa	#oažži#mássá
muskelomfang	N	lihasten koko	oččiid #ollis
muskelprotein	N	lihasproteiini	#oažži#proteidna
muskelspenning	N	lihasjännite	oažžegealdu
muskelsvekkelse	N	lihasheikkous	oažžeheadju
muskelsvinn	N	lihasten surkastuminen	lihasatrofia	oččiid 
muskelsykdom	N	lihassairaus	oažžebuohcu
muskelvolum	N	lihasvolyymi  lihastilavuus	oažževoluma #oažži#daddjásvuohta  
nakkevirvel	N	kaulanikama	
næringsdrikke	N	ravintojuoma	biebmanjugus
næringsinnhold	N	ravintosisältö	biebmansisdoallu
næringsinntak	N	ravinnon saanti	biebmama oažžun
næringsløsning	N	ravintoneste	biebmansiedja
næringsmiddelhygiene	N	elintarvikehygienia	borramušgálvobuhtisindoallan
næringssammensetning	N	ravitsemusyhdistelmä	biebmokombinašuvdna
næringsstoffanbefaling	N	ravintoainesuositus	biebmanávnnasneavva
næringstett	N	energiarikas	
næringstilførsel	N	ravinnonsaanti	biebmamaoažžun
narkose	N	nukutus	yleisanestesia	
narrativ	N	narratiivi	kertomus	#narratiiva
nærvær	N	läsnäolo	
nattbordsbrett	N	yöpöydän ruokailutaso	idjabeavddi borrandássi
nattevakt	N	yövuoro	idjavuorru
nattkjole	N	yöpaita	idjabáidi
natturin	N	yövirtsa	idjagužža
navlestreng	N	napanuora	
nedkjøling	N	kylmettyminen	
nekrose	N	kuolio	nekroosi	
nekrose	N	kuolio nekroosi	*kuolio #nekrosa
nervebane	N	hermorata	#nervaluodda
nerveimpuls	N	hermoimpulssi	#nervaimpulsa
nesekateter	N	nenäkatetri	#njunni#katehtár
nestekjærlighet	N	lähimmäisenrakkaus	
nestenuhell	N	lähesonnettomuus	
nettingstruse	N	verkkohousut	galjatbuvssat
nettmobbing	N	nettikiusaaminen	neahttagivssideapmi
nettportal	N	internetportaali  nettiportaali	*internetportaali  
nettverksintervensjon	N	verkostotyön menetelmä	verkostotyön interventio	fierbmebarggu mannolat
nettverkskartlegging	N	sosiaalisen verkoston kartoitus	#sosiálalaš fierpmi kárten
nevrolog	N	neurologi	
nevrologi	N	neurologia	
nevrose	N	neuroosi	ahdistuneisuushäiriö	
nitrat	N	nitraatti	
nitrogen	N	typpi	
nøkkelrolle	N	avainrooli	čoavddarolla
nonverbal	N	nonverbaalinen sanaton	
normalflora	N	normaalifloora	
normalflora	N	normaalifloora normaalimikrobisto	
normalfunksjon	N	normaalitoiminta	
normalgrense	N	normaalin raja	normála rádji
normalitetsbegrep	N	normaalisuuskäsite	
normalområde	N	viitealue	čujuhusguovlu
normalposisjon	N	normaaliasento	
normaltemperatur	N	normaali lämpötila	#normála temperatuvra
normalvariasjon	N	normaalivaihtelu	
normalverdi	N	normaaliarvo	
novise	N	noviisi	vasta-alkaja	#noviisa
novisenivå	N	noviisitaso aloittelijan taso	#noviisadássi #álggahalli dássi
nyrefunksjon	N	munuaisten toiminta	manimučča doaibma
nyrelidelse	N	munuaistauti	#monimušdávda
nyreregion	N	munuaisten alue	manimučča guovlu
nyreskade	N	munuaisvaurio	#monimuš#vaháguvvan
nyrestein	N	munuaiskivi	#monimušgeađgi
nyresvikt	N	munuaisten vajaatoiminta	manimučča 
nyresykdom	N	munuaissairaus	#monimušbuohcu
nyresykdom	N	munuaistauti	#monimušdávda
nyreterskel	N	munuaiskynnys	#monimuššielbmá
nyttekriterium	N	hyötykriteeri	guddakriteara
objektglass	N	näytelasi	čájánasláse
obstruksjonsgrad	N	ahtauman aste	baskkádaga #ráđđa
ødem	N	turvotus	
ødemsamling	N	nesteen kertyminen kehoon	sieja *kertyminen rupmašii
ødemvæske	N	turvokuksen aiheuttama nestekertymä	
oksygenbehandling	N	happihoito	oksygenadikšu
oksygenbehov	N	hapentarve	oksygenadárbu
oksygenforbruk	N	hapen käyttö	oksygena atnin
oksygeninnhold	N	happipitoisuus	oksygenasisdoallu
oksygennivå	N	happitaso	oksygenadássi
oksygenopptak	N	hapenotto	#oksygena#váldin
oksygensbrille	N	happiviikset	oksygenaskávžžát
oksygenterapi	N	happihoito		oksygenadikšu
oksygentilførsel	N	hapen anto	oksygena addin
oksygentransport	N	hapenkuljetus	oksygenafievrrideapmi
oksygenutstyr	N	happilaite	oksygenarusttet
oljeklyster	N	öljyperäruiske	
omgangskrets	N	tuttavapiiri	oahpesbiire
omgivelsestemperatur	N	ympäristön lämpötila	birrasa temperatuvra
ømhet	N	hellyys	herkkyys	
omsorgsbegrep	N	hoidon käsite	divššu doaba
omsorgsdepartement	N	hoidon ministeriö	divššu ministeriija
omsorgsetikk	N	hoitotyön etiikka	dikšobarggu etihkka
omsorgsfilosofi	N	hoitotyön filosofia	dikšobarggu filosofiija
omsorgsformål	N	hoivatarkoitus	fuolahanulbmil
omsorgsgiver	N	hoitava henkilö	#hoitát olmmoš
omsorgskultur	N	hoivakulttuuri	fuolahankultuvra
omsorgsmodell	N	hoitotyön malli	dikšobarggu #málle
omsorgsoppgave	N	sairaanhoidon tehtävät hoivatehtävä	buohccedivššu doaimmat fuolahandoaibma
omsorgsrelasjon	N	hoitosuhde	dikšogorri
omsorgsressurs	N	hoivaresurssit	fuolahanresurssat
omsorgssjef	N	kunnallinen terveyden ja sairaanhoidon johtaja	#suohkanlaš healssa ja buohccedivššu hoavda
omsorgstjenestelov	N	terveydenhuoltolaki	healssadikšunláhka
omsorgstradisjon	N	hoivaperinne	fuolahanárbevierru
omsorgsutøver	N	hoidon antaja	divššu #addi
omsorgsverdi	N	hoitotyön arvot	dikšobarggu árvvut
omverden	N	ympäristö	biras
ønskekost	N	toiveruoka	doaivvagušta
operasjonshette	N	hiussuojus 	
oppgulp	N	pulautus	
opphopning	N	kasautuminen	
oppsamling	N	kerääminen	kerääntyminen	čoaggit
oppsamlingskolbe	N	keräysastia	#čoaggilihtti
oppsamlingspose	N	keräyspussi	#čoaggibusse
oppsamlingssystem	N	keräysjärjestelmä	#čoaggivuogádat
oppsummeringsskjema	N	koontilomake	
oppvaskmiddel	N	tiskiaine	
optiker	N	optikko	
ordinere	N	määrätä	mearridit
øreskylling	N	korvahuuhtelu	#beallji#doidildeapmi
øretermometer	N	korvakuumemittari	
organfunksjon	N	elintoiminto	orgánadoaibma
organisasjonskultur	N	organisaatiokulttuuri	organisašuvdnakultuvra
organisasjonslæring	N	organisaation oppiminen	organisašuvnna oahppat
organskade	N	elinvaurio	#orgána#vaháguvvan
organsystem	N	elinjärjestelmä	orgánavuogádat
orgasmefase	N	orgasmivaihe	#orgasmamuddu
orgasmeproblem	N	orgasmiongelma	#orgasmaproblema
orienteringsevne	N	orientoitumiskyky	
osmose	N	osmoosi	
østrogen	N	estrogeeni	østrogena
østrogenfall	N	estrogeenitason lasku	østrogenadási rehket
østrogenmangel	N	estrogeenivaje	
østrogennivå	N	estrogeenitaso	østrogenadássi
østrogenproduksjon	N	estrogeenin tuotanto	østrogena duddjon
østrogentilskudd	N	estrogeenilisä	østrogenalassi
overdosedødsfall	N	yliannostuskuolema	
overflowinkontinens	N	ylivuotoinkontinessi	
overkropp	N	yläruumis	
overløpsinkontinens	N	ylivuotoinkontinenssi	
overskuddsvæske	N	liika neste ylimääräinen neste	liigi siedja #badjelmearálaš siedja
overstrekk	N	yliojennus venähdys	
overvåkning	N	valvonta	bajilgeahčču
øvingsprogram	N	harjoitusohjelma	hárjehusprográmma
øyekontakt	N	silmäkontakti	čalbmekontákta
p-pille	N	e-pilleri	ehkäisypilleri	
påkledd	N	puettu	
palliasjon	N	palliatiivinen hoito	oireita lievittävä hoito	*palliatiivinen dikšu
pandemi	N	pandemia	erittäin laajalle levinnyt epidemia	pandemiija
parese	N	osittaishalvaus	pareesi	
parforhold	N	parisuhde	bárragorri
parkinsonisme	N	parkinsonismi	
pasientautonomi	N	potilaan itsemääräämisoikeus	#buohcci iešmearridanvuoigatvuohta
pasienteksempel	N	potilasesimerkki	#buohccieksempel
pasienterfaring	N	potilaskokemus	#buohccivásihus
pasientforløp	N	hoitopolku	dikšoluodda
pasientfortelling	N	kertomus sairaudesta ja potilaanaolosta	muitalus buozus ja 
pasienthistorie	N	potilaan kertomus	#buohcci muitalus
pasienthistorie	N	potilashistoria potilaan kertomus	#buohccihistorjá #buohcci muitalus
pasientinformant	N	potilasinformantti	#buohcciinformánta
pasientinformasjon	N	potilasohje	#buohccibagadus
pasientintegritet	N	potilaan integriteetti potilaan loukkaamattomuus	#buohcci *integriteetti #buohcci 
pasientjournal	N	potilaskertomus	#buohccimuitalus
pasientjournalsystem	N	potilaskertomusjärjestelmä	#buohcci#muitalusvuogádat
pasientkontakt	N	potilaskontakti	#buohccikontákta
pasientmedvirkning	N	potilaan osallistaminen	#buohcci 
pasientomsorg	N	potilashoito		#buohccidikšu
pasientoppfølging	N	potilaan seuranta	#buohcci čuovvuleapmi
pasientopphold	N	potilaana olo	#buohcci eksisteansa
pasientopplæring	N	potilasopetus	#buohccioahpahus
pasientopplevelse	N	kokemus potilaanaolosta	vásihus 
pasientopplysning	N	potilastiedot	#buohccidieđut
pasientorganisasjon	N	potilasjärjestö	#buohcciorganisašuvdna
pasientproblem	N	potilasongelma	#buohcciproblema
pasientrolle	N	potilasrooli	#buohccirolla
pasientsikkerhetsprogram	N	potilasturvallisuusohjelma	#buohcci#sihkarvuohtaprográmma
pasientskadeerstatning	N	potilasvahinkokorvaus	#buohcci#vahátbuhtadas
pasienttrygghet	N	potilasturvallisuus	#buohccisihkarvuohta
pasientvurdering	N	potilaan hoidotarpeen arviointi	#buohcci *hoidotarpeen evalueren
passasjehindring	N	läpikulkueste	ráigejohtueastta
passform	N	sopivuus	
påstandskunnskap	N	väitetietämys	čuoččuhusdiehtu
paternalisme	N	paternalismi	
patofysiologi	N	patofysiologia	buođđofysiologiija
pediatri	N	lastentaudit	pediatria	mánáiddávddat
penetrere	N	tunkeutua sisään	läpäistä	*tunkeutua sisa
penicillin	N	penisilliini	
penishode	N	peniksen kärki terska	diri geahči 
penishode	N	peniksen pää	diri #oaivi
penispumpe	N	penispumppu	dirrepumpa
penisskaft	N	siittimen varsi	nálkku nađđa
perkusjon	N	naputtelu	
perkutere	N	naputella ja kuunnella sisäelimiä	*naputella ja guldalit 
persepsjon	N	havaitseminen	áicat
personlighetsegenskap	N	persoonallisuuden piirre	*persoonallisuuden sárggus
personopplysning	N	henkilötieto	olmmošdiehtu
pessar	N	pessaari	
pessimisme	N	pessimismi	
pestsykdom	N	ruttotauti	roahttodávda
ph	N	pH	happamuus	
pigment	N	pigmentti		
pigmentforandring	N	pigmenttimuutos	
piping	N	piippaus	
plasmaprotein	N	plasmaproteiini	#varragolggus#proteidna
plasmavolum	N	plasmatilavuus plasmavolyymi	#varragolggus#daddjásvuohta varragolggosvoluma
plastinnlegg	N	muovisuoja	plastihkkasuodji
plastkateter	N	muovikatetri	#plastihkka#katehtár
platåfase	N	tasannevaihe	
pleieassistent	N	hoitoapulainen	dikšoveahkki
pleiekultur	N	hoitokulttuuri	dikšokultuvra
pleielidelse	N	hoitokärsimys	dikšogillámuš
pleiemedhjelper	N	hoitoapulainen	dikšoveahkki
pleiemiddel	N	hoitoaine	dikšoávnnas
pleieoppgave	N	hoitotoimi hoitotyön tehtävä	dikšodoaibma dikšobarggu doaibma
pleiepersonale	N	hoitohenkilökunta	dikšoolmmošgielda
pleieplan	N	hoitotyön suunnitelma	dikšobarggu plána
pleiesituasjon	N	hoitotilanne	dikšodilli
pliktfølelse	N	velvollisuudentunto	geatnegasvuođadovdu
plukking	N	poimiminen	nyppiminen	gaskit
pollusjon	N	tahaton siemensyöksy 	
pool	N	sijaispooli	
porsjonsstørrelse	N	annoskoko	
poseprøve	N	virtsanäyte pussista	cissaiskkus busses
praksiskontekst	N	käytännön konteksti	geavada konteaksta
praksisperiode	N	harjoitusjakso	hárjehusoassi
praksissted	N	käytännön harjoittelupaikka	geavada hárjehallanbáiki
praksisteori	N	käytännön teoria	geavada teoriija
praktiker	N	käytännön toimija	geavada aktevra
prestasjonspress	N	suorituspaine	čađahandeaddu
primærsykepleier	N	oma sairaanhoitaja	#ieš #buohccidikšu
prioriteringskriterium	N	priorisointikriteeri	ovdasadjekriteara
problemidentifisering	N	ongelman tunnistaminen	problema dovdát
problemløsning	N	ongelman ratkaisu	problema čoavddus
problemsituasjon	N	ongelmatilanne	problemadilli
profesjonsfag	N	ammattiopinnot	
profesjonsgrad	N	ammattitutkinto	
profesjonsutøver	N	ammattialan harjoittaja	
projeksjon	N	projektio	sijoittaminen	
pronasjon	N	pronaatio	sisäänkierto	
prosedyreverktøy	N	toimenpiteiden hakutyökalu	doaibmabijuid ohcanreaidu
prosesskriterium	N	prosessikriteeri	proseassakriteara
prostatabesvær	N	eturauhasvaiva	
prostatakjertel	N	eturauhanen	ávkeráksá
prostataoperasjon	N	eturauhasleikkaus	
proteinkvalitet	N	proteiinin laatu	#proteidna dássu
proteinmangel	N	proteiinivaje	
proteinreserve	N	valkuaisainevaranto proteiinivaranto	
proteintilskudd	N	proteiinilisä	#proteidnalassi
protese	N	proteesi	dahkulahttu
prøveglass	N	näytelasi	čájánasláse
prøveresultat	N	koetulos  testitulos	iskanboađus teastaboađus  
prøvesvar	N	koetulos	iskanboađus
pubertetsstadium	N	puberteettivaihe	
pubertetsutvikling	N	murrosiän kehitys	*murrosiän ahtanuššan
pukkelrygg	N	kyttyräselkä  köyryselkä kyfoosi	*kyttyräselkä  
pulsforandring	N	sykkeen muutos	*sykkeen iežáhus
pulsfrekvens	N	syketiheys	
pulsklokke	N	sykekello	
pulsrytme	N	sykkeen rytmi	*sykkeen ritma
pulstelling	N	pulssin mittaus	ravkasa mihtideapmi
pumpeevne	N	pumppauskyky	
pumpefunksjon	N	pumppaustoiminta	
pumpekraft	N	pumppausvoima	
puss	N	mätä	märkäinen erite	guohca
pussbekken	N	kaarimalja	dávgegearra
pusting	N	hengitys  hengittäminen	vuoigŋan  sahkat
rådgivningsklinikk	N	neuvontayksikkö neuvontaklinikka	rávvehusovttadat rávvehusklinihkka
rammefaktor	N	puitetekijä	
rapportering	N	raportointi	antaa raportti	
rapsolje	N	rapsiöljy	
reaksjonsevne	N	reaktiokyky	reakšuvdnagálga
reaksjonsmåte	N	reaktiotapa	reakšuvnna
reaksjonsmønster	N	reaktiotapa	reakšuvnna
realitetssans	N	todellisuudentaju	duođalašvuođaipmárdus
realitetssjokk	N	todellisuusshokki  realiteettishokki	#duođalašvuohtašohkka 
referanseverdi	N	viitearvo	čujuhusárvu
refleksjonsgruppe	N	reflektioryhmä	reflekšuvdnajoavku
refleksjonsnotat	N	reflektiokirjoitus	reflekšuvdnačála
refleksjonssamtale	N	reflektointikeskustelu	
regnbuemodell	N	sateenkaarimalli	bajándávgemálle
reguleringsmekanisme	N	säätelymekanismi	muddenmekanisma
reguleringssenter	N	säätelykeskus	#mudden#guovddaš
rehabilitere	N	kuntouttaa	
rehabiliteringsfase	N	kuntoutusjakso	veajuiduhttinoassi
rehabiliteringsforløp	N	kuntoutuspolku	veajuiduhttinluodda
rehabiliteringsinstitusjon	N	kuntoutuslaitos	veajuiduhttinásahus
rehabiliteringsopphold	N	kuntoutusjakso	veajuiduhttinoassi
reinnleggelse	N	toistuva sairaalahoito???	#dáhpáhuvvat 
reminisens	N	muistelu	#muitin
reparasjonshvile	N	korjaava lepo	#muddet vuoiŋŋasteapmi
reproduksjon	N	reproduktio	lisääntyminen	
reseptregister	N	reseptirekisteri	reseaptaregisttar
reservekapasitet	N	reservikapasiteetti	#hearbevárri#kapasitehtta
reservelager	N	varmuusvarasto	#vissisvuohtarádju
respirasjon	N	hengitys	vuoigŋan
respirasjon	N	hengitys	respiraatio	vuoigŋan
respirasjonsarbeid	N	hengitystyö	vuoigŋanbargu
respirasjonsbesvær	N	hengenahdistus	dyspnea	heakkaáŧestus
respirasjonsbevegelse	N	hengitysliike	vuoigŋangávpi
respirasjonsdybde	N	hengityksen syvyys	vuoigŋama čikŋodat
respirasjonsforstyrrelse	N	hengityshäiriö	vuoigŋansegohus
respirasjonsfrekvens	N	hengitystaajuus	vuoigŋandávjodat
respirasjonsfrekvens	N	hengitystiheys	#vuoiŋandávjodat
respirasjonsmønster	N	hengitystapa	vuoigŋandáhpi
respirasjonsmuskel	N	hengityslihas	vuoigŋanoažži
respirasjonsmuskulatur	N	hengityslihaksisto	
respirasjonsorgan	N	hengityselimet	vuoigŋanorgánat
respirasjonsproblem	N	hengitysongelma	vuoigŋanproblema
respirasjonsrytme	N	hengitysrytmi	vuoigŋanritma
respirasjonssenter	N	hengityskeskus	#vuoigŋan#guovddaš
respirasjonsstans	N	hengityspysähdys	
respirasjonsstatus	N	hengityksen kliininen status	vuoigŋama #klinihkalaš stáhtus
respirasjonsstøtte	N	hengitystuki	vuoigŋanduvdda
respirasjonssyklus	N	hengityssykli	
respirasjonssyklus	N	hengityssykli	
respirasjonssystem	N	hengitysjärjestelmä	vuoigŋanvuogádat
respiratorpasient	N	hengityskonepotilas	#vuoigŋan#mašiidna#buohcci
responssenter	N	hälytyskeskus	#alárbma#guovddaš
responssystem	N	palautejärjestelmä	
ressurskriterium	N	resurssikriteeri	resursakriteara
ressurssvikt	N	resurssivaje	
restitusjon	N	toipuminen	
resturin	N	jäännösvirtsa	bázahasgužža
retardasjon	N	jälkeenjääneisyys	hidastuminen	
reviewstudie	N	systemaattinen kirjallisuuskatsaus	systemáhtalaš #girjjálašvuohtadárkkistus
ribbeinsbrudd	N	kylkiluun murtuma	sárddi 
ringmuskel	N	sulkijalihas	
risikogruppe	N	riskiryhmä	riskajoavku
risikopasient	N	riskipotilas	#riska#buohcci
risikovurderingskala	N	riskinarviointiasteikko	riskkaevaluerenceahkkálas
risikovurderingsskjema	N	riskien arviointilomake	riskkaid evaluerenskovvi
risikovurderingsskjema	N	riskinarviointilomake	riskkaevaluerenskovvi
risting	N	ravistelu	
rolleatferd	N	roolikäyttäytyminen	rollaláhttenvuohki
rollekonflikt	N	rooliristiriita	rollakonflikta
rollemodell	N	roolimalli	rollamálle
rommelighet	N	rommelig avara tilava	*rommelig *avara čáhkkil
røntgenundersøkelse	N	röntgentutkimus	#röntgenadutkan
rullestolrampe	N	pyörätuoliramppi  pyörätuoliluiska	juvlastovlastealli  
rusmiddelbruk	N	päihteiden käyttö	*päihteiden atnin
rusmiljø	N	huumepiiri	narkotihkkabiire
rusmisbruker	N	huumausaineiden väärinkäyttäjä	huumeenkäyttäjä	
ryggleie	N	selinmakuu 	
ryggmargsbrokk	N	hermostoputken sulkeutumishäiriö  meningomyeloseele	MMC 	nearvafierbmebohcci *sulkeutumishäiriö  
ryggmargsskade	N	selkäydinvaurio	#sealgi#ađa#vaháguvvan
ryggsøyle	N	selkäranka	
ryggvask	N	selänpesu	sealggebassan
rytmeforstyrrelse	N	rytmihäiriö	ritmasegohus
sædavgang	N	siemensyöksy	
sædblære	N	rakkularauhanen	skoavhleráksá
sædblære	N	rakkularauhanen		skoavhleráksá
sædproduksjon	N	siittiöiden tuotanto	*siittiöiden duddjon
sædutløsning	N	siemensyöksy	
sædvæske	N	siemenneste	gilvvasiedja
sakkarin	N	sakkariini	
saltinnhold	N	suolapitoisuus	sáltesisdoallu
saltinntak	N	suolansaanti	sáltteoažžun
saltvann	N	suolaliuos	sáltečuokkisčoahkku
samfunnsnivå	N	yhteiskuntataso	searvvušdássi
samfunnsrytme	N	yhteiskunnan rytmi	servoša ritma
samhandlingskompetanse	N	yhteistyötaito	ovttasbargodáidu
samhandlingssituasjon	N	yhteistyötilanne	ovttasbargodilli
samlebetegnelse	N	yhteiskäsite	
samleiestilling	N	yhdyntäasento	anašanstellelmas
samlivskurs	N	parisuhdekurssi	#bárra#gorri#gursa
sammenlikningsgrunnlag	N	vertailuperuste	veardáduságga
samordning	N	yhteensovittaminen	
samtalegruppe	N	keskusteluryhmä	gulahallanjoavku
samtalepartner	N	keskustelukumppani	gulahallanguoibmi
samtaletempo	N	keskustelun tempo	gulahallama 
samtaleterapi	N	keskusteluterapia	gulahallanterapiija
samtykkekompetanse	N	itsemääräämiskyky	#iešmearrideapmigálga
samvalg	N	yhteispäätös	
samvalgsverktøy	N	yhteispäätöstä auttava väline	*yhteispäätöstä #veahkehit #gaskoapmi
sanitærforhold	N	hygieeniset olosuhteet	hygieeninen tila	*hygieeniset eksisteansagorit
sansehage	N	aistipuutarha	dovddagárdin
sansning	N	aistiminen	tuntemus	
såperest	N	saippuajäämä	
såpestykke	N	saippuapala	sovppábinná
såpevann	N	saippuavesi	sovppáčáhci
såpevask	N	saippuapesu	sovppábassan
sårbehandling	N	haavanhoito	subedikšu
sårbunn	N	haavan pohja	subi bodni
sårdannelse	N	haavan kehittyminen	subi ovddideapmi
sårfase	N	haavan vaihe	subi muddu
sårheling	N	haavan paraneminen	subi 
sårhet	N	arkuus	
sårinfeksjon	N	haavatulehdus	haavainfektio	hávvevuolši
sårkant	N	haavan reuna	subi ravda
sårpoliklinikk	N	haavapoliklinikka	hávvepoliklinihkka
sårsekresjon	N	haavaerite	#hávvi#čuolddašupmi
sårskift	N	haavanhoito	subedikšu
sårskifte	N	haavanhoito	subedikšu
sårstell	N	haavanhoito	subedikšu
sårtype	N	haavatyyppi	hávvetiipa
sårveiledning	N	haavahoidon ohjaus	hávvedivššu bagadallan
sårveiledning	N	haavanhoidon ohjaus	subedivššu bagadallan
sårvurdering	N	haavan arviointi	subi evalueren
schizofreni	N	skitsofrenia	
score	N	pisteytys	
screene	N	seuloa	sevlet
sekresjonsmengde	N	eritteen määrä	#čuolddašupmi #mearri
seksualitetsmangfold	N	seksuaalinen moninaisuus  seksuaalinen monimuotoisuus	#seksuálalaš máŋggaláganvuohta  #seksuálalaš máŋggahámatvuohta
sekundærlitteratur	N	sekundäärikirjallisuus	toissijainen kirjallisuus	
selvaktelse	N	itsetunto	omanarvontunto	iešdovdu
selvhjelpløsning	N	oma-apukeino  omahoitokeino	#ieš-veahkkegeaidnu  
selvhjelpsgruppe	N	oma-apuryhmä	#ieš-veahkkejoavku
selvhjelpsverktøy	N	itsehoitoväline	#iešdikšu#gaskoapmi
selvhjulpenhet	N	omatoimisuus	
selvrealisering	N	itsensä toteuttaminen	ieš ollašupmi
selvskading	N	itsensä vahingoittaminen	ieš #billi
sengeklær	N	vuodevaatteet	gávnnit
sengeleie	N	makuuasento	vuodehoito	
senkningsreaksjon	N	lasko  senkka	*lasko  
sensitivitet	N	herkkyys	hearkivuohta
sensorteknologi	N	sensoriteknologia	
serumjern	N	seerumin rauta	*seerumin ruovdi
sideleie	N	kylkiasento	erttetstellelmas
signalmolekyl	N	signaalimolekyyli	
signalsubstans	N	signaaliaine	
sikkerhetsteknologi	N	turvallisuusteknologia	#sihkarvuohtateknologiija
silikon	N	silikoni	
sinneutbrudd	N	vihanpurkaus	#suhttu#russun
sinnsstemning	N	mieliala	hállosuorgi
sinusknute	N	sinussolmuke	
sinusrytme	N	sinusrytmi	
sirkelbevegelse	N	kehäliike	birasgávpi
sirkulære	N	kiertää	garvit
sirkulasjonsforhold	N	verenierron tila	*verenierron dilli
sirkulasjonsproblem	N	verenkierto-ongelma	varagarvinproblema
sirkulasjonssystem	N	verenkiertojärjestelmä	varagarvinvuogádat
sittestilling	N	istuma-asento	
sjenanse	N	kainous	häpeä	
sjokktilstand	N	shokkitila	šohkkadilli
skår	N	pisteytys	
skavank	N	vamma	vika	veaidni
skiftarbeid	N	vuorotyö	vuorrobargu
skifting	N	vaihto	muutos	#molsuheapmi
skikkethet	N	soveltuvuus	
skittentøysekk	N	pyykkipussi	
skjedeåpning	N	emättimen aukko	viiggá ráigi
skjedekatarr	N	emättimen bakteeritasapainon häiriö bakteerivaginoosi	viiggá 
skjedekrampe	N	emätinkouristus	
skjedekrans	N	immenkalvo hymen	
skjedevegg	N	emättimen seinämä  vaginan seinämä	viiggá seaidni  viiggá seaidni
skjeggvekst	N	parrankasvu	
skjelettmuskulatur	N	luustolihas	luurankolihas	dákteriggeoažži
skjelettsystem	N	luujärjestelmä	dáktevuogádat
skjermbrett	N	väliverho	gaskaláseliidni
skjønnhetsideal	N	kauneusihanne	
sklerose	N	skleroosi	kovettuma	
skolemåltid	N	kouluateria	skuvlamális
skrekkanfall	N	pelkokohtaus	#ballu#dohppehallat
skrøpelighet	N	hauraus	
skulderledd	N	olkanivel	
skumgummipute	N	vaahtomuovityyny	soarpaplastihkkaguoddá
skummadrass	N	vaahtomuovipatja	soarpaplastihkkaguoddá
skummateriale	N	vaahtomuoviaine	soarpaplastihkkaávnnas
slagfrekvens	N	syketaajuus	
slaggprodukt	N	kuona-aine	
slagpasient	N	aivohalvauspotilas	#vuoigŋašat#ravkin#buohcci
slagrehabilitering	N	aivoverenkiertohäiriön kuntoutus AVH-kuntoutus	*aivoverenkiertohäiriön veajuiduhttin 
slagvolum	N	iskutilavuus	iskuvolyymi	#časkkástat#daddjásvuohta
slapphet	N	voimattomuus	fámuhisvuohta
slimhinneødem	N	limakalvoturvotus	
slimmobilisering	N	liman liikkeelle saaminen	njivlli gávpái oažžut
slimproduksjon	N	liman tuotanto	njivlli duddjon
slimsekresjon	N	limaneritys	njivllevuohčun
smertebehandling	N	kivunhoito	bákčasadikšu
smertelindring	N	kivunlievitys	
smerteopplevelse	N	kivun kokemus	bákčasa vásihus
smerteproblem	N	kipuongelma	bávččasproblema
smertepumpe	N	kipupumppu	bávččaspumpa
smertesans	N	kipuaisti	bávččasdovdda
smertescore	N	kivun pistemäärä	bákčasa čuokkesmearri
smertetegn	N	kivun merkki	bákčasa mearka
smertetilstand	N	kiputila	bávččasdilli
smerteuttrykk	N	kivun ilmenemismuoto	bákčasa dovdot hápmi
smittekjede	N	tartuntaketju	njoammunviđji
smitteoverføring	N	tartunnan levittäminen tartunnan leviäminen	njoammuma lebbet njoammuma leavvat
smitterisiko	N	tartuntariski	njoammunriska
smittespredning	N	tartunnan leviäminen	njoammuma leavvat
snevring	N	ahtauma	kurouma	baskkádat
somatikk	N	elimelliset toiminnot	*elimelliset doaimmat
sondeernæring	N	lekturuokinta	enteraalinen ravitsemus	
sondeløsning	N	letkuruokintavalmiste	
sondespiss	N	sondin kärki	*sondin geahči
soppinfeksjon	N	sieni-infektio	guopparinfekšuvdna
soppmiddel	N	sienenestoaine sienilääke	guobbaracaggasanávnnas guoppardálkkas
sorgprosess	N	suruprosessi	morašproseassa
sorgreaksjon	N	surureaktio	morašreakšuvdna
sovestilling	N	nukkumisasento	oađđit stellelmas
søvnbehov	N	unentarve	nahkáradárbu
søvndagbok	N	unipäiväkirja	nagirbeaivegirji
søvnfase	N	unen vaihe	nahkára muddu
søvnhygiene	N	unihygienia	nagirbuhtisindoallan
søvnighet	N	unisuus	
søvnkvalitet	N	unen laatu	nahkára dássu
søvnlengde	N	unen pituus	nahkára guhkkodat
søvnmangel	N	unen puute	nahkára váilevuohta
søvnmengde	N	unen määrä	nahkára #mearri
søvnmønster	N	unirytmi	nagirritma
søvnperiode	N	unijakso	nagiroassi
søvnplage	N	univaikeus	nagirváttisvuohta
søvnregistrering	N	unen rekisteröinti	nahkára logahallan
søvnrestriksjon	N	unen rajoittaminen	nahkára ráddjet
søvnrutine	N	unirutiini	nagirrutiidna
søvnstadium	N	unen vaihe	nahkára muddu
søvnsykdom	N	unisairaus	nagirbuohcu
søvnsyklus	N	unijakso	nagiroassi
søvnsyklus	N	unisykli	
søvnunderskudd	N	univaje	
søvnvane	N	unitapa	nagirdáhpi
søvnvanske	N	univaikeus	nagirváttisvuohta
spekter	N	kirjo	#girjjogárjjohallat
spesialist	N	spesialisti	
spesialistgodkjenning	N	erikoistumisen hyväksyntä	sierraneami dohkkeheapmi
spesialseng	N	erikoissänky	
spissbekken	N	naisten alusastia	nissoniid álgolihtti
spissfot	N	riippujalka	
spolorm	N	suolinkainen	gávdnjarakkis
sporstoff	N	hivenaine	#binnánašávnnas
sprekkdannelse	N	halkeaman muodostuminen	luoddanit 
springvann	N	vesijohtovesi  hanavesi	čáhcejođasčáhci  
spyttkjertel	N	sylkirauhanen	čolgaráksá
spyttkjertel	N	sylkirauhanen		čolgaráksá
spyttproduksjon	N	syljeneritys	čolggavuohčun
spyttsaft	N	sylki  sylkineste	čolga  čolgasiedja
spyttsekresjon	N	syljeneritys	čolggavuohčun
ss	N	rkl	ruokalusikka	
standpunkt	N	näkökanta	oaidnojocca
stær	N	kaihi	
ståseng	N	seisomismahdollisuudella varustettu sänky	čuožžut liibbas *varustettu seaŋga
steindannelse	N	kivien muodostuminen	geđggiid 
stellekort	N	yksilöllinen hoito-ohje	individuála dikšobagadus
stemmeleie	N	äänenpaino	jienadeaddu
stemmespalte	N	äänirako	jietnasálvu
stemmevolum	N	äänen voimakkuus	jiena givrodat
stemningsleie	N	mieliala	hállosuorgi
stereotype	N	stereotyyppi  kaavoittuma	stereotiipa  
stikklaken	N	poikkilakana	
stikkpille	N	peräpuikko suppo	
stikkskade	N	pistovamma	
stillingsendring	N	asennonvaihto	#stellelmas#molsuheapmi
stillingsforandring	N	asennonvaihto	#stellelmas#molsuheapmi
stillingsvern	N	työsuhdeturva	bargogorredorvu
stimuli	N	ärsyke	
stimuluskontroll	N	ärsykkeen hallinta	*ärsykkeen kontrolla
stoffmisbruker	N	huumausaineiden väärinkäyttäjä	
stoffomsetning	N	aineenvaihdunta	#ávnnasmolsašuvvan
stoffskifteprosess	N	aineenvaihduntaprosessi	#ávnnasmolsašuvvanproseassa
stoffskiftesykdom	N	aineenvaihduntasairaus	#ávnnasmolsašuvvanbuohcu
stoffskiftesykdom	N	aineenvaihduntasairaus		#ávnnasmolsašuvvanbuohcu
stolpute	N	istuintyyny	beaŋkaguoddá
stolvekt	N	tuolivaaka	stovlaveakta
støttehåndtak	N	tukikahva	duvddauksageavja
støttekondom	N	tukikondomi	duvddakondoma
støtteverktøy	N	tukityökalu	duvddareaidu
støtteverktøy	N	tukiväline	#duvdda#gaskoapmi
støynivå	N	melutaso	riedjadássi
støyskade	N	meluvaurio	#riedja#vaháguvvan
strålebehandling	N	sädehoito	suonjardikšu
stråleprøve	N	näyte virtsasuihkusta	čájánas gužžarišus
stråleskade	N	sädetysvaurio	
stressfaktor	N	stressitekijä	#hušša#dahkki
stresshormon	N	stressihormoni	huššahormona
stressinkontinens	N	ponnistusinkontinenssi	rahčamušinkontineansa
stresspåvirkning	N	stressin vaikutus	huša váikkuhus
strimmelundersøkelse	N	liuskatesti	
strømhastighet	N	virtausnopeus	rávdnjejohtilvuohta
strupelokk	N	kurkunkansi	#gurkálohkki
strupelokk	N	kurkunkansi		#gurkálohkki
studieoppgave	N	opintotehtävä	lohkandoaibma
studiesirkel	N	opintopiiri	lohkanbiire
sug	N	imu	
sukkermolekyl	N	sokerimolekyyli	
sukrose	N	sakkaroosi	sokeri	
sulfat	N	sulfaatti	
sunnhet	N	terveys	healsa
supinasjon	N	supinaatio	uloskierto	
surhetsgrad	N	happamuusaste	
surstoffapparat	N	happilaite	oksygenarusttet
svangerskapsforgiftning	N	raskausmyrkytys pre-eklampsia	#lossatvuohtamirkkohus 
svartedauden	N	musta surma	#čáhppat jápmu
svelgeevne	N	nielemiskyky	njiellat gálga
svelgeproblem	N	nielemisvaikeus	njiellat váttisvuohta
svelgfunksjon	N	nielemistoiminto	njiellat doaibma
svelgparese	N	nielemispareesi	
svelgtest	N	nielemistesti nielemiskoe	njiellat teasta njiellat iskan
svettetokt	N	hikoilukohtaus	
sykdomsårsak	N	sairauden syy  taudin syy	buozu árta  dávdda árta
sykdomsbegrep	N	sairauden määritelmä	buozu definišuvdna
sykdomsbehandling	N	sairauden hoito	buozu dikšu
sykdomsbyrde	N	sairaustaakka  sairauskuorma	buohconoađđi buohcoguorbmi  
sykdomsbyrde	N	tautitaakka	sairauden taakka	dávdanoađđi
sykdomsdiagnose	N	tautidiagnoosi	dávdadiagnosa
sykdomsepisode	N	sairausjakso	buohcooassi
sykdomserfaring	N	sairauden kokemus	buozu vásihus
sykdomsfase	N	sairauden vaihe	buozu muddu
sykdomsfølelse	N	sairauden tunne	buozu dovdu
sykdomsforløp	N	sairauden kulku	buozu johtu
sykdomsforståelse	N	sairauden ymmärrys	buozu ádden
sykdomshistorie	N	potilaan selvitys terveysongelmista	#buohcci čilgehus healsaproblemain
sykdomslære	N	tautioppi	dávdaoahppu
sykdomsmodell	N	tautimalli	dávdamálle
sykdomsoppfatning	N	sairauskäsitys	buohcoipmárdus
sykdomsopplevelse	N	sairauskokemus	buohcovásihus
sykdomspanorama	N	sairauspanoraama	#buohcu#panoraama
sykdomsperspektiv	N	sairausperspektiivi	buohcoperspektiiva
sykdomsproblem	N	sairausongelma	buohcoproblema
sykdomsprognose	N	sairauden ennuste  sairauden prognoosi	buozu einnostus  buozu 
sykdomsprosess	N	sairausprosessi	sairauden kulku	buohcoproseassa
sykdomssituasjon	N	sairaudentila	buozodilli
sykdomssyn	N	sairauskäsitys	buohcoipmárdus
sykdomstilstand	N	sairaudentila	buozodilli
sykdomsutvikling	N	sairauden kulku	buozu johtu
sykehjemsbeboer	N	hoitokodin asukas	dikšogođiiguin #ássi
sykehjemsbestyrer	N	hoivakodin johtaja	fuolahangođiiguin hoavda
sykehjemslege	N	hoivakodin lääkäri	fuolahangođiiguin doavttir
sykehjemspasient	N	hoivakotipotilas	#fuolaheapmi#ruoktu#buohcci
sykehusavdeling	N	sairaalaosasto	
sykehusinfeksjon	N	sairaalainfektio	
sykehusinnleggelse	N	sairaalapotilaaksi kirjaaminen sairaalapotilaaksi meneminen	
sykehusmiljø	N	sairaalamiljöö	
sykehusopphold	N	hoitojakso sairaalassa	dikšooassi buohcceviesus
sykehuspasient	N	sairaalapotilas	
sykehusprest	N	sairaalapappi	
sykehusseng	N	sairaalasänky	
sykehusskjorte	N	potilaspaita	#buohccibáidi
sykepleiebehov	N	hoidontarve	divššodárbu
sykepleiedefinisjon	N	hoitotyön määritelmä	dikšobarggu definišuvdna
sykepleiediagnose	N	sairaanhoidon diagnoosi	buohccedivššu diagnosa
sykepleiedokumentasjon	N	hoitotyön kirjaaminen	dikšobarggu 
sykepleieepikrise	N	sairaanhoidon yhteenveto  sairaanhoidon tiivistelmä	buohccedivššu oktiigeassu  buohccedivššu 
sykepleiefag	N	hoitotiede??	dikšodieđa?
sykepleieferdighet	N	hoitotyön kädentaidot	dikšobarggu gieđadáiddut
sykepleieferdighet	N	hoitotyön taidot	dikšobarggu dáiddut
sykepleiefilosofi	N	sairaanhoidon filosofia	buohccedivššu filosofiija
sykepleieforsker	N	sairaanhoidon tutkija	buohccedivššu #dutki
sykepleieforskning	N	sairaanhoidon tutkimus	buohccedivššu dutkan
sykepleiefunksjon	N	sairaanhoidon tehtävä  sairaanhoidon tarkoitus	buohccedivššu doaibma  buohccedivššu ulbmil
sykepleiehåndbok	N	hoitotyön käsikirja	dikšobarggu giehtagirji
sykepleiehandling	N	sairaanhoidollinen toiminta	*sairaanhoidollinen doaibma
sykepleiehjelp	N	sairaanhoito	buohccedikšu
sykepleieintervensjon	N	sairaanhoidollinen toimenpide	*sairaanhoidollinen doaibmabidju
sykepleiekapasitet	N	sairaanhoidon kapasiteetti	buohccedivššu #kapasitehtta
sykepleiekompetanse	N	sairaanhoidollinen kompetenssi	sairaanhoidollinen pätevyys	*sairaanhoidollinen gelbbolašvuohta
sykepleiekunnskap	N	hoitotyön tieto	dikšobarggu diehtu
sykepleiekunnskap	N	sairaanhoidon tietämys	buohccedivššu diehtu
sykepleiekvalitet	N	sairaanhoidon laatu	buohccedivššu dássu
sykepleiemetode	N	sairaanhoidon menetelmä	buohccedivššu mannolat
sykepleiemodell	N	hoitotyön malli	dikšobarggu #málle
sykepleienotat	N	sairaanhoidon merkintä	buohccedivššu merken
sykepleieområde	N	 sairaanhoidon alue	 buohccedivššu guovlu
sykepleieoppgave	N	hoitotyön tehtävä	dikšobarggu doaibma
sykepleieperspektiv	N	sairaanhoidon näkökanta sairaanhoidollinen näkökulma	buohccedivššu oaidnojocca *sairaanhoidollinen #oaidninčiega
sykepleieplan	N	hoitosuunnitelma	dikšoplána
sykepleiepraksis	N	sairaanhoitokäytäntö	buohccedikšogeavat
sykepleieprinsipp	N	sairaanhoidon periaate	buohccedivššu prinsihppa
sykepleieproblem	N	hoitotyön ongelma	dikšobarggu problema
sykepleieprofesjon	N	sairaanhoidon ammattiala	buohccedivššu 
sykepleieprosedyre	N	sairaanhoidollinen menetelmä	*sairaanhoidollinen mannolat
sykepleieprosess	N	hoitotyön prosessi	dikšobarggu proseassa
sykepleieresultat	N	hoidon tulos	divššu boađus
sykepleierhøgskole	N	sairaanhoitaja-ammattikorkeakoulu	AMK	
sykepleierprofesjon	N	sairaanhoitajan ammatti	#buohccidikšu #ámmát
sykepleierrolle	N	sairaanhoitajan rooli	#buohccidikšu rolla
sykepleierske	N	sairaanhoitajatar	
sykepleierstudent	N	sairaanhoidon opiskelija	buohccedivššu studeanta
sykepleieruniform	N	sairaanhoitajan univormu	#buohccidikšu 
sykepleiesammenheng	N	sairaanhoidollinen asiayhteys	*sairaanhoidollinen ásiioktavuohta
sykepleiestudent	N	sairaanhoidon opiskelija	buohccedivššu studeanta
sykepleiesystem	N	sairaanhoidon järjestelmä	buohccedivššu vuogádat
sykepleietenkning	N	hoitotyön ajattelu sairaanhoidollinen ajattelu	dikšobarggu jurddašeapmi *sairaanhoidollinen jurddašeapmi
sykepleieteoretiker	N	hoitotyön teoreetikko	dikšobarggu 
sykepleieteori	N	hoitotyön teoria	dikšobarggu teoriija
sykepleietiltak	N	hoitotoimet	dikšodoaimmat
sykepleietjeneste	N	sairaanhoidon palvelut	buohccedivššu bálvalusat
sykepleietjeneste	N	sairaanhoitopalvelut	buohccedikšobálvalusat
sykepleieutøving	N	sairaanhoidon suoritus	buohccedivššu čađaheapmi
sykepleieverdi	N	hoitotyön arvot	dikšobarggu árvvut
sykepleievitenskap	N	hoitotiede	dikšodieđa
symptomerfaring	N	oireiden kokemus	symptomaid vásihus
symptomlindring	N	oireen lievitys	symptoma 
symptomopplevelse	N	oireiden kokemus	symptomaid vásihus
synkope	N	synkopee	pyörtyminen	
synsinntrykk	N	näköaistimus  visuaalinen vaikutelma	*näköaistimus  visuálalaš 
synsskarphet	N	näöntarkkuus	oainnodárkkuhus
synsvanske	N	näköhäiriö	oaidnosegohus
synsvidde	N	näkökentän laajuus	oaidnogietti viidodat
syreangrep	N	happohyökkäys	suvrefalleheapmi
syrekapp	N	happovaippa	suvrelihpar
syrekappe	N	happovaippa	suvrelihpar
syreoverskudd	N	happoylijäämä	suvrebadjebáza
systemkretsløp	N	iso verenkierto systeeminen verenkierto	stuoris varagarvin *systeeminen varagarvin
systemteori	N	systeemiteoria	systemateoriija
tablettform	N	tablettimuoto	
tabuområde	N	tabualue	tabuguovlu
takheis	N	kattoon kiinnitetty siirtolaite	rohpái *kiinnitetty sirdinrusttet
tålbar	N	siedettävä	
taleevne	N	puhekyky	hupmagálga
talevanske	N	puhehäirö	
talg	N	tali	tálga
talgkjertel	N	talirauhanen	tálgaráksá
talgproduksjon	N	talineritys	tálggavuohčun
tallerkenkant	N	lautasen reunus	#dallearka 
tallerkenmodell	N	lautasmalli	
talsperson	N	edustaja  puolesta puhuja	áirras  bealis #hubmi
tankeprosess	N	ajatusprosessi	ájáhusproseassa
tankevirksomhet	N	ajatustoiminta	ájáhusdoaibma
tannbein	N	hammasluu	bátnedákti
tannemalje	N	kiille	
tannhals	N	hampaan kaula	báni čeabi
tannkjøtt	N	ien	aldna
tannløsning	N	hampaiden irtoaminen	bániid luovvanit
tannprotese	N	hammasproteesi	bátneprotesa
tannpuss	N	hampaiden puhdistus	bániid buhtástus
tannstatus	N	hampaiden terveydentila	bániid healssadilli
tannstell	N	hampaiden hoito	bániid dikšu
tapping	N	tyhjentäminen	poisvaluttaminen	gurret
tarmaktivitet	N	suoliston aktiivisuus	*suoliston aktiviteahtta
tarmbakterie	N	suolistobakteeri	
tarmbevegelse	N	suolen liikkeet	čoali gávppit
tarmfunksjon	N	suolen toiminta	čoali doaibma
tarmgass	N	suolistokaasu	
tarminfeksjon	N	suolistoinfektio	
tarminnhold	N	suolen sisältö	čoali sisdoallu
tarmkanal	N	suolisto	
tarmkontroll	N	suolen hallinta	čoali kontrolla
tarmluft	N	suolistoilma	
tarmparasitt	N	suolistoloinen suolistoparasiitti	
tarmpassasje	N	suolistoreitti	
tarmslimhinne	N	suoliston limakalvo	*suoliston šliiveassi
tarmsykdom	N	suolistosairaus	
tarmsystem	N	suolisto	
tarmtømming	N	suolen tyhjennys	čoali 
tarmvegg	N	suolen seinämä	čoali seaidni
tarmvolum	N	suolensisällön volyymi	čoalesisdoalu voluma
taushetsbestemmelse	N	vaitiolopäätös	
teknologiforståelse	N	teknologian ymmärtäminen	teknologiija ipmárdus
telefonveiledning	N	puhelinohjaus	telefovdnabagadallan
temperaturforhold	N	lämpøolosuhteet	
temperaturforhøyelse	N	kuumeen nousu	febera #loktaneapmi
temperaturforstyrrelse	N	kehon lämpötilan häiriö	rupmaša temperatuvrra segohus
temperaturmåling	N	lämmönmittaus	lieggasamihtideapmi
temperaturregulering	N	lämmönsäätely	#liekkasvuohtamudden
temperatursans	N	lämpöaisti	liekkasdovdda
temperaturstigning	N	lämmönnousu	#liekkas#loktaneapmi
temperaturutvikling	N	kehon lämpötilan kehittyminen	rupmaša temperatuvrra ovddideapmi
tenningsmønster	N	syttymistapa	buollát dáhpi
teorinivå	N	teoriataso	teoriijadássi
teoriutvikling	N	teorian kehitys	teoriija ahtanuššan
termometer	N	lämpömittari	
termostatinnstilling	N	termiostaatin asetus	*termiostaatin ásahus
termostatinnstilling	N	termostaatin asento 	termostáhta stellelmas 
tertiærnæring	N	palveluelinkeino	bálvalusealáhus
testikkelkreft	N	kivessyöpä	bálloboras
testmåltid	N	testiateria	teastamális
tidsbruk	N	ajankäyttö	áiggeatnin
tidsdimensjon	N	aikaulottuvuus	áigeolli
tidsopplevelse	N	ajan kokemus	áiggi vásihus
tidsorientering	N	aikaan orientoituminen	áigái 
tidspress	N	aikapaine	áigedeaddu
tilfredsstillelse	N	tyydyttyminen	
tilknytningsteori	N	kiintymyssuhdeteoria	
tilleggsbelastning	N	lisätaakka	lassenoađđi
tilleggskrav	N	lisävaatimus	lassegáibádus
tillitsforhold	N	luottamussuhde	dorvogorri
tilsetning	N	lisä	lassi
tilsetningsmiddel	N	lisäaine	lasseávnnas
tilsynsrapport	N	valvontaselvitys	bajilgeahččočilgehus
tilsynssak	N	valvonta-asia	bajilgeahččoásii
tjenesteforløp	N	hoitopolku	dikšoluodda
tjenestekvalitet	N	palvelun laatu	bálvalusa dássu
tjenesteutøvelse	N	palvelunalan harjoittaminen	bálvalussuorggi hárjehit
tjenesteutvikling	N	palveluiden kehittäminen	bálvalusaid ovddideapmi
toalettbesøk	N	vessassa käynti	hivssegis galledeapmi
toalettforhøyer	N	WC-istuimen koroke	*WC-beaŋkka aládas
toalettrutine	N	vessassakäytnirutiini	
toalettvane	N	vessassakäyntitavat	
tømming	N	tyhjennys	
tømmingsmønster	N	tyhjentymiskäytäntö	guorranit geavat
tømmingsplage	N	tyhjennysvaiva	
tømmingsproblem	N	suolen tyhjennysongelma	čoali 
tømmingsrefleks	N	suolen tyhjennysrefleksi	čoali 
tømmingsrefleks	N	ulostusrefleksi	
tømmingsregime	N	suolen tyhjennyssuunnitelma	čoali 
tømmingstrang	N	ulostamistarve	
tømmingsvane	N	tyhjentämistapa	gurret dáhpi
tømmingsvanske	N	tyhjentämishäiriö	gurret segohus
tonefall	N	äänenpaino	jienadeaddu
tørstfølelse	N	janon tunne	goikku dovdu
totalprotese	N	kokoproteesi	
tradisjonsgrunnlag	N	perinnepohja	árbevierrobodni
transduser	N	muunnin	
transfett	N	transrasva	
transkjønn	N	transsukupuoli	
transperson	N	transhenkilö	
transportmedium	N	kuljetusaine	fievrridanávnnas
transseksualisme	N	transseksualismi	
traume	N	trauma	trauma
trekantprinsipp	N	kolmikantaperiaate	
treningsregime	N	harjoitusohjelma	hárjehusprográmma
trigger	N	laukaisija	
trombose	N	veritulppa	
trombosering	N	veritulppien muodostumineN	tukosten muodostuminen	
trygghetopplevelse	N	turvallisuuden kokemus	sihkarvuođa vásihus
trygghetsalarm	N	turvahälytin	
trykkavlastning	N	paineen helpottaminen	deattu álkidit
trykkmadrass	N	painehaavapatja	deaddohávveguoddá
trykksår	N	painehaavauma	deaddouddu
trykksårrisiko	N	painehaavariski	deaddohávveriska
trykkskade	N	painevaurio	#deaddu#vaháguvvan
tubespiss	N	tuubin kärki	*tuubin geahči
tumor	N	kasvain	tuumori	guorti
tunnelsyn	N	kapeakatseisuus	
turistdiaré	N	turistiripuli	turistalužas
tutekopp	N	nokkamuki	geahčemugga
tvangsbehandling	N	pakkohoito	bággodikšu
tvangsbruk	N	pakon käyttö	bákku atnin
tvangslovgivning	N	tahdosta riippumatonta hoitoa tai pakkohoitoa koskeva lainsäädäntö	dáhtus 
tvangsmating	N	pakkosyöttö	bággoboraheapmi
tvangsmedisinering	N	pakkolääkitys	bággodálkun
tykningsmiddel	N	sakeutusaine	
tyngdefornemmelse	N	painon tunne	deattu dovdu
uavhengighetsregel	N	riippumattomuussäännös	
ukrenkelighet	N	loukkaamattomuus	
ultralydapparat	N	ultraäänilaite	
ultralydmaskin	N	ultraäänilaite	
ultralydundersøkelse	N	kaikututkimus  ultraäänitutkimus	skádjadutkan  
umyndiggjøring	N	vajaavaltaiseksi julistaminen	*vajaavaltaiseksi almmustit
underlivvask	N	alapesu	suorgebassan
underrapportering	N	aliraportointi	
undersøkelsesmetode	N	tutkimusmenetelmä  tutkimusmetodi	dutkanmannolat dutkanmetoda  
understøtte	N	tukea	duvdit
understøttelsesflate 	N	tukipinta	duvddaaláš
undervekt	N	alipaino	
unnlatelse	N	tekemättä jättäminen	dahkat guođđit
unnlatelsessynd	N	tekemättäjättämisen synti	*tekemättäjättämisen suddu
urinavgang	N	virtsaaminen	
urinblære	N	virtsarakko	gužžaráhkku
urinering	N	virtsaus	
urinflaske	N	virtsapullo	gužžabohtal
urininkontinens	N	virtsankarkailu	virtsainkontinenssi	gužžagolgan
urininkontinens	N	virtsankarkailu virtsainkontinenssi	gužžagolgan gužžainkontineansa
urinkateter	N	virtsakatetri	#gužža#katehtár
urinleder	N	virtsajohdin	
urinlekkasje	N	virtsankarkailu virtsainkontinenssi	gužžagolgan gužžainkontineansa
urinmengde	N	virtsamäärä	gužžamearri
urinpose	N	virtsapussi	gužžabusse
urinproduksjon	N	virtantuotanto	
urinsamling	N	virtsankeräys	#gužža#čoaggi
urinstråle	N	virtsasuihku	gužžariššu
urinstrøm	N	virtsasuihku	gužžariššu
urintrykk	N	virtsan paine	gučča deaddu
urinutskillelse	N	virtsaneritys	guččavuohčun
urinutskilling	N	virtsaneritys	guččavuohčun
urinvolum	N	virtsan määrä	gučča #mearri
urørlighetssone	N	koskemattomuusvyöhyke	
utånding	N	uloshengitys	
utåndingsluft	N	uloshengitysilma	
utenforskap	N	hyljeksinnän kokemus	*hyljeksinnän vásihus
utfoldelse	N	avautuminen	tapahtuminen	#rahppot
utfoldelsesmulighet	N	itsensä ilmentämismahdollisuudet          Trond sjekka språk hit	N		ieš čájehit liibbat          Trond 
utholdenhetstrening	N	kestävyysharjoittelu	#gillilvuohtahárjehallan
utmattelse	N	uupumus	
utmattelsessyndrom	N	väsymysoireyhtymä	
utskrivelse	N	uloskirjoitus	
utskriving	N	uloskirjoitus	
utskrivingsbrev	N	kotiutuskirje	
utskrivningssamtale	N	keskustelu ennen uloskirjoitusta	gulahallan ovdal 
uttørring	N	kuivuminen	goikat
uttrykksmåte	N	ilmaisutapa	dajahusdáhpi
uttrykksmiddel	N	ilmaisukeino	dajahusgeaidnu
utviklingshemning	N	kehitysvamma	ahtanuššanveaidni
utviklingstrinn	N	kehitysaste	#ahtanuššan#ráđđa
vaginisme	N	vaginismi	emätinkouristus	
våkenhet	N	valveillaolo	
vaktskifte	N	vuoronvaihto	#vuorru#molsuheapmi
vakttelefon	N	päivystyspuhelin	fáktatelefovdna
vanninnhold	N	vesipitoisuus	čáhcesisdoallu
vannklyster	N	vesiperäruiske	
varedeklarasjon	N	tuoteseloste	
varhet	N	varovaisuus	helläkätisyys	várrogasvuohta
varmelaken	N	hätäpeite avaruuspeitto	heahtegovččas #gomuvuohtagovččas
varmelaken	N	lämpölakana suojapeite	*lämpölakana suodjegovččas
varmepose	N	lämpöpussi	liekkasbusse
varmeproduksjon	N	lämmön tuotanto	lieggasa duddjon
varmestråling	N	lämmönsäteily	lieggasasuonjardeapmi
varmetapet	N	lämmmönhukka	
varmeutmattelse	N	auringonpistos hypertermia	
væskeansamling	N	nestekertymä	
væskebalanse	N	nestetasapaino	siedjabalánsa
væskebehandling	N	nestehoito	siedjadikšu
væskebehov	N	nesteen tarve	sieja dárbu
væskeinfusjon	N	nesteinfuusio	#siedja#infušuvdna
væskeinnhold	N	nestepitoisuus	siedjasisdoallu
væskeinntak	N	nesteensaanti	siejaoažžun
væskemangel	N	nestevajaus nestevaje	siedjaváili 
væskemengde	N	nestemäärä	siedjamearri
væskeopphopning	N	nestekertymä	
væskeoverskudd	N	nesteylimäärä	
væskeregistrering	N	nestemäärien kirjaaminen	siedjameriid 
væskeregnskap	N	nestetasapainon kirjaus 	siedjabalánssa 
væskerestriksjon	N	nesterajoitus	siedjaoahci
væskeskjema	N	pesutaulukko	bassantabealla
væsketap	N	nestevajaus	siedjaváili
væsketilførsel	N	nesteensaanti	siejaoažžun
væskeunderskudd	N	nestevajaus	siedjaváili
vedlikeholdsomsorg	N	ylläpitohoito	bajásdoalahusdikšu
vegetarrett	N	kasvisruoka	ruonasgušta
veiingstest	N	punnitustesti	
vekseltrykk	N	vaihtuva paine	#molsašuvvat deaddu
veksthormon	N	kasvuhormoni	šaddohormona
vekstmedium	N	elatusaine	
vektendring	N	painonmuutos	deattoiežáhus
vektkurve	N	painokäyrä	deaddosodju
vektøkning	N	painonnousu	#deaddu#loktaneapmi
vektreduksjon	N	painonpudotus	deattogahččan
vektreduksjonstiltak	N	painonpudotustoimenpide	deattogahččandoaibmabidju
vekttap	N	painon putoaminen	deattu gahččat
vektutvikling	N	painon kehitys	deattu ahtanuššan
velbehag	N	mielihyvä	dáhttu
velferdssystem	N	hyvinvointijärjestelmä	čálgovuogádat
velgjørenhetsprinsipp	N	hyväntekemisen periaate	*hyväntekemisen prinsihppa
vellukt	N	hyvä tuoksu	buorre 
velværeteknologi	N	hyvinvointiteknologia	čálgoteknologiija
venekateter	N	laskimokatetri	#moraš#katehtár
veneklaff	N	laskimoläppä	morašleahppi
veneport	N	laskimoportti	morašpoarta
venesystem	N	laskimojärjestelmä	morašvuogádat
venetrombose	N	laskimotukos	#morčesuotnabuđohat
venetrombose	N	laskimotukos  laskimotromboosi	#morčesuotnabuđohat  
veneutvidelse	N	laskimolaajentuma	
verdensbegrep	N	maailmankuva  maailmankäsitys	
verdikonflikt	N	arvokonflikti	arvoristiriita	árvokonflikta
verdimodell	N	arvomalli	árvomálle
vevhormon	N	kudoshormoni	gođushormona
vevskade	N	kudosvaurio	#gođus#vaháguvvan
vevsvæske	N	kudosneste	gođussiedja
videokonsultasjon	N	videovastaanotto	videovuhtiiváldin
virkelighetsflukt	N	pako todellisuudesta	báhtareapmi duođalašvuođas
virkemåte	N	vaikutustapa	váikkuhusa
virus	N	virus	virus
virusanalyse	N	virusanalyysi	virusanaliisa
virussykdom	N	virussairaus	virusbuohcu
vitamindråpe	N	vitamiinitippa	vitamiidnagoaikkanas
vitaminstatus	N	vitamiinitila	vitamiidnadilli
vitenskapstradisjon	N	tiedetraditio	dieđaárbevierru
volumendring	N	tilavuuden muutos	#daddjásvuohta iežáhus
vurderingsprosess	N	arviointiprosessi	evaluerenproseassa
yrkesfelt	N	ammattiala	
yrkesidentitet	N	ammatti-identiteetti	
yrkesrolle	N	ammattirooli	
yrkesutøving	N	ammatin harjoittaminen	ámmáha hárjehit
yteevne	N	suorituskyky	čađahangálga
