sjekkliste	N	
forvirre	V	
avlastning	N	
dilemma	N	
problemstilling	N	
hofte	N	
hjerneslag	N	
kar	N	
karsykdom	N	
hofte	N	
hofte	N	
sykehjem	N	
inndele	V	
innvirkning	N	
ivaretakelse	N	
kartlegging	N	
spesialisthelsetjeneste	N	
leddbevegelighet	N	
sluttfase	N	
ly	N	
mestre	N	
mestringsstrategi	N	
miljøtiltak	N	
omsorgsarbeid	N	
opplæring	N	
oversikt	N	
mestre	V	
samtykke	N	
samtykke	V	
søvn	N	
sykehjem	N	
tilnærme	V	
kartlegging	N	
vurderingsskjema	N	
